	ЗАО																							
	ЛТД																							
	НЕИЗВЕСТНЫЙ ПРОИЗВОДИТЕЛЬ																							
	ОАО																							
	ООО																							
	ПКФ																							
	ТОО																							
	B.V																							
	Corp.																							
	GmbH																							
	IBC																							
	Inc																							
	LDC																							
	LLC																							
	LLP																							
	LTD																							
	PLC																							
	SARL																							
 	, 																							
г	гр.																							
ФФ	Ф.Ф.																							
ФП	ФАРМ.ПРЕДПРИЯТИЕ																							
ФФ	ФАРМ.Ф-КА																							
ФФ	фармацевтическая фабрика																							
ФФ	фармфабрика																							
0 Г	0Г																							
0 Л	0Л																							
0 М	0М																							
0 Х	0Х																							
0 X	0X																							
1 %	1%																							
1 Г	1Г																							
1 г	1г																							
1 Л	1Л																							
1 л	1л																							
1 М	1М																							
1 Х	1Х																							
1 X	1X																							
2 Г	2Г																							
2 г	2г																							
2 Л	2Л																							
2 л	2л																							
2 М	2М																							
2 Х	2Х																							
2 X	2X																							
3 Г	3Г																							
3 г	3г																							
3 Л	3Л																							
3 л	3л																							
3 М	3М																							
3 Х	3Х																							
3 X	3X																							
4 Г	4Г																							
4 г	4г																							
4 Л	4Л																							
4 л	4л																							
4 М	4М																							
4 Х	4Х																							
4 X	4X																							
5 Г	5Г																							
5 г	5г																							
5 Л	5Л																							
5 л	5л																							
5 М	5М																							
5 Х	5Х																							
5 X	5X																							
6 Г	6Г																							
6 г	6г																							
6 Л	6Л																							
6 л	6л																							
6 М	6М																							
6 Х	6Х																							
6 X	6X																							
7 Г	7Г																							
7 г	7г																							
7 Л	7Л																							
7 л	7л																							
7 М	7М																							
7 Х	7Х																							
7 X	7X																							
8 Г	8Г																							
8 г	8г																							
8 Л	8Л																							
8 л	8л																							
8 М	8М																							
8 Х	8Х																							
8 X	8X																							
9 Г	9Г																							
9 г	9г																							
9 Л	9Л																							
9 л	9л																							
9 М	9М																							
9 Х	9Х																							
9 X	9X																							
МГ/	МГ/																							
Х 0	Х0																							
Х 1	Х1																							
Х 2	Х2																							
Х 3	Х3																							
Х 4	Х4																							
Х 5	Х5																							
Х 6	Х6																							
Х 7	Х7																							
Х 8	Х8																							
Х 9	Х9																							
ХФК	ХИМ.-ФАРМ.КОМПАНИЯ																							
ХФЗ	Химфармзавод																							
N 1	N1																							
N 2	N2																							
N 3	N3																							
N 4	N4																							
N 5	N5																							
N 6	N6																							
N 7	N7																							
N 8	N8																							
N 9	N9																							
№ 1	№1																							
№ 2	№2																							
№ 3	№3																							
№ 4	№4																							
№ 5	№5																							
№ 6	№6																							
№ 7	№7																							
№ 8	№8																							
№ 9	№9																							
2 %	2%																							
3 %	3%																							
4 %	4%																							
5 %	5%																							
6 %	6%																							
7 %	7%																							
8 %	8%																							
9 %	9%																							
0 %	0%																							
0 мг	0мг																							
0 мл	0мл																							
0 мл	0мл																							
0 СМ	0СМ																							
1 мг	1мг																							
1 мл	1мл																							
1 мл	1мл																							
1 СМ	1СМ																							
2 мг	2мг																							
2 мл	2мл																							
2 мл	2мл																							
2 СМ	2СМ																							
3 мг	3мг																							
3 мл	3мл																							
3 мл	3мл																							
3 СМ	3СМ																							
4 мг	4мг																							
4 мл	4мл																							
4 мл	4мл																							
4 СМ	4СМ																							
5 мг	5мг																							
5 мл	5мл																							
5 мл	5мл																							
5 СМ	5СМ																							
6 мг	6мг																							
6 мл	6мл																							
6 мл	6мл																							
6 СМ	6СМ																							
7 мг	7мг																							
7 мл	7мл																							
7 мл	7мл																							
7 СМ	7СМ																							
8 мг	8мг																							
8 мл	8мл																							
8 мл	8мл																							
8 СМ	8СМ																							
9 мг	9мг																							
9 мл	9мл																							
9 мл	9мл																							
9 СМ	9СМ																							
крем	КРЕМЕМ																							
МГ/ 	МГ/																							
0 ДОЗ	0ДОЗ																							
0 мг/	0мг/																							
0 мг+	0мг+																							
0 МЕС	0МЕС																							
0 МКГ	0МКГ																							
1 ДОЗ	1ДОЗ																							
1 мг/	1мг/																							
1 мг+	1мг+																							
1 МЕС	1МЕС																							
1 МКГ	1МКГ																							
2 ДОЗ	2ДОЗ																							
2 мг/	2мг/																							
2 МЕС	2МЕС																							
2 МКГ	2МКГ																							
3 ДОЗ	3ДОЗ																							
3 мг/	3мг/																							
3 мг+	3мг+																							
3 МЕС	3МЕС																							
3 МКГ	3МКГ																							
4 ДОЗ	4ДОЗ																							
4 мг/	4мг/																							
4 мг+	4мг+																							
4 МЕС	4МЕС																							
4 МКГ	4МКГ																							
5 ДОЗ	5ДОЗ																							
5 мг/	5мг/																							
5 мг+	5мг+																							
5 МЕС	5МЕС																							
5 МКГ	5МКГ																							
6 ДОЗ	6ДОЗ																							
6 мг/	6мг/																							
6 мг+	6мг+																							
6 МЕС	6МЕС																							
6 МКГ	6МКГ																							
7 ДОЗ	7ДОЗ																							
7 мг/	7мг/																							
7 мг+	7мг+																							
7 МЕС	7МЕС																							
7 МКГ	7МКГ																							
8 ДОЗ	8ДОЗ																							
8 мг/	8мг/																							
8 мг+	8мг+																							
8 МЕС	8МЕС																							
8 МКГ	8МКГ																							
9 ДОЗ	9ДОЗ																							
9 мг/	9мг/																							
9 мг+	9мг+																							
9 МЕС	9МЕС																							
9 МКГ	9МКГ																							
 для 	 д/																							
 ДРАЖЕ	 ДР.																							
 ДРАЖЕ 	 ДРЖ 																							
 капли 	 кпл 																							
сироп	СИРОПОП																							
 СИРОП 	 СИР. 																							
 СИРОП 	 СИР 																							
 ТРАВА 	 ТР 																							
 ДЛЯ 	Д/																							
 КАПЛИ	 КАП.																							
КУ-ТАБ	КУ-ТАБ																							
 РАЗМЕР	 Р.																							
 СИРОП	 СИР.																							
 флакон 	 ФЛ 																							
ФЛАКОН	ФЛ.																							
 КАПЛИ	 КПЛ 																							
 КАПЛИ	 КАП. 																							
 5-НОК 	 5 НОК 																							
 Д-САН 	 Д САН 																							
2 мг + 	2мг+																							
 ампулы	 АМП.																							
 ГРАНУЛЫ 	 ГРАН 																							
КИСЛОТА	К-ТА																							
капсулы	КАПЛИСУЛЫ																							
 ЛЕДЕНЦЫ 	 ЛЕД 																							
 ПАКЕТ 	 ПАК 																							
 СИРОП 	 СИР 																							
 СПРЕЙ 	 СПР. 																							
 ТАМПОНЫ 	 ТАМП 																							
ШАМПУНЬ	 ШАМП 																							
ШАМПУНЬ	 ШАМП.																							
шампунь	ШАМПУНЬУНЬ																							
 ГОУ-ОН 	 ГОУ ОН 																							
 ДЕ-НОЛ 	 ДЕ НОЛ 																							
 ЙОД-КА 	 ЙОД КА 																							
 НО-ШПА 	 НО ШПА 																							
для глаз	Д/ГЛ																							
ЖИДКОСТЬ	ЖИДК																							
 КАПСУЛЫ	 КАПС.																							
КОЛГОТКИ	КОЛГОТ																							
 ЛИНИМЕНТ 	 ЛИНИМ 																							
 ЛИНИМЕНТ	 ЛИНИМ.																							
 ПИЛЮЛИ 	 ПИЛ 																							
раствора	р-ра																							
размер м	р.м																							
размер L	р.L																							
размер M	р.M																							
размер S	р.S																							
 ТАБЛЕТКИ 	 тбл 																							
 ТАБЛЕТКИ 	 ТБЛ.																							
 АНКИР-Б 	 АНКИР Б 																							
 БАК-СЕТ 	 БАК СЕТ 																							
 БАЮ-БАЙ 	 БАЮ БАЙ 																							
 ГОНАЛ-Ф 	 ГОНАЛ Ф 																							
 ДИКЛО-Ф 	 ДИКЛО Ф 																							
 ПК-МЕРЦ 	 ПК МЕРЦ 																							
 СЕДАЛ-М 	 СЕДАЛ М 																							
 ЦИ-КЛИМ 	 ЦИ КЛИМ 																							
 ТАБЛЕТКИ	,ТБЛ																							
ИМПЛАНТАТ	ИМПЛАНТ																							
 КАПСУЛЫ 	 КАПС 																							
 КАПСУЛЫ 	 КАПС. 																							
КРЕМ-ГЕЛЬ	КР-ГЕЛЬ																							
КРЕМ-ПЕНА	КР-ПЕНА																							
 ПОРОШОК 	 ПОР 																							
 ПОРОШОК 	 ПОР. 																							
 РАСТВОР 	 Р-Р 																							
размер XL	р.XL																							
размер XS	р.XS																							
 ЭЛИКСИР 	 ЭЛИКС 																							
 ЭЛИКСИР 	 ЭЛИКС. 																							
 КАПСУЛЫ 	 КАПС 																							
 КАПСУЛЫ 	 КАПС.																							
 СФ (SF)  	 SF  																							
 БИО-МАКС 	 БИО МАКС 																							
 БЛОГИР-3 	 БЛОГИР 3 																							
 ВИТА-ПОС 	 ВИТА ПОС 																							
 ДЕО-ХЛОР 	 ДЕО ХЛОР 																							
 ДИАНЕ-35 	 ДИАНЕ 35 																							
 ЛЕВЗЕЯ-П 	 ЛЕВЗЕЯ П 																							
 МИЛОНА-5 	 МИЛОНА 5 																							
 ПЕПСАН-Р 	 ПЕПСАН Р 																							
 СКИН-КАП 	 СКИН КАП 																							
 ТРИГАН-Д 	 ТРИГАН Д 																							
 УЛЬТРА-Д 	 УЛЬТРА Д 																							
 УРАЛИТ-У 	 УРАЛИТ У 																							
 АЭРОЗОЛЬ 	 АЭР. 																							
БАЛЬЗАМ ОТ	БАЛЬЗ ОТ																							
 БАТОНЧИК 	 БАТ 																							
ГАЗ СЖАТЫЙ	ГАЗ СЖАТ																							
ДЛЯ НОГТЕЙ	Д/НОГТЕЙ																							
КРЕМ-ПАСТА	КР -ПАСТА																							
ЛИОФИЛИЗАТ	ЛИОФИЛ																							
 НАСТОЙКА 	 Н-КА 																							
ПОДКОЖНОГО	П/К																							
 ПАСТИЛКИ 	 ПАСТ 																							
 пастилки 	 ПАСТ. 																							
 ПЛАСТЫРЬ 	 ПЛАСТ 																							
ПОДГУЗНИКИ	 ПОДГУЗ 																							
размер XXL	р.XXL																							
 ТАБЛЕТКИ 	 ТАБ 																							
 таблетки 	 ТАБ. 																							
 СУСПЕНЗИЯ	 СУСП.																							
 ДЖО (JO)  	 JO  																							
 А-ЦЕРУМЕН 	 А ЦЕРУМЕН 																							
 АВИА-МОРЕ 	 АВИА МОРЕ 																							
 АСКОФЕН-П 	 АСКОФЕН П 																							
 АСПИРИН-С 	 АСПИРИН С 																							
 БОМ-БЕНГЕ 	 БОМ БЕНГЕ 																							
 ВИД-КОМОД 	 ВИД КОМОД 																							
 ГЕПА-МЕРЦ 	 ГЕПА МЕРЦ 																							
 ДОКСИ-ХЕМ 	 ДОКСИ ХЕМ 																							
 ИОВ-ВЕНУМ 	 ИОВ ВЕНУМ 																							
 ЙОД-АКТИВ 	 ЙОД АКТИВ 																							
 КВАДРАТ-С 	 КВАДРАТ С 																							
 КЛЕЙ БФ-6 	 КЛЕЙ БФ 6 																							
 КО-ДИОВАН 	 КО ДИОВАН 																							
 ЛЕВЕТОН-П 	 ЛЕВЕТОН П 																							
 ЛЕКРА-СЭТ 	 ЛЕКРА СЭТ 																							
 НЕРВО-ВИТ 	 НЕРВО ВИТ 																							
 ПРО-ВИЗИО 	 ПРО ВИЗИО 																							
 РЕМО-ВАКС 	 РЕМО ВАКС 																							
 СИНЯК-ОФФ 	 СИНЯК ОФФ 																							
 ТИРЕО-ВИТ 	 ТИРЕО ВИТ 																							
 ТРИ-МЕРСИ 	 ТРИ МЕРСИ 																							
 ТРИ-РЕГОЛ 	 ТРИ РЕГОЛ 																							
 ФИТОЛОР-М 	 ФИТОЛОР М 																							
 ЦИТОВИР-3 	 ЦИТОВИР 3 																							
 БУТЫЛОЧКА 	 БУТ 																							
БЮСТГАЛЬТЕР	 БЮСТ 																							
КАПЛИ НАБОР	КАП НАБОР																							
КАПЛИ УШНЫЕ	КАП УШ																							
КРЕМ-МАССАЖ	КР -МАССАЖ																							
МАЗЬ ЖИРНАЯ	МАЗЬ ЖИР																							
МЫЛО ЖИДКОЕ	МЫЛО ЖИД																							
размер XXXL	р.XXXL																							
РАСТВОРИМЫЙ	РАСТВ-Й																							
 СУСПЕНЗИЯ 	 СУСП 																							
 СУСПЕНЗИЯ 	 СУСП. 																							
 СФМ (SFM)  	 SFM  																							
 АЗИКС-ДЕРМ 	 АЗИКС ДЕРМ 																							
 АЛЬКА-ПРИМ 	 АЛЬКА ПРИМ 																							
 АНГИН-ХЕЛЬ 	 АНГИН ХЕЛЬ 																							
 АНТИ-АНГИН 	 АНТИ АНГИН 																							
 АУРОН-РИТМ 	 АУРОН РИТМ 																							
 ГЛИЦИН-БИО 	 ГЛИЦИН БИО 																							
 Д-ПАНТЕНОЛ 	 Д ПАНТЕНОЛ 																							
 ИМУРОН-ВАК 	 ИМУРОН ВАК 																							
 КАЛЬЦИЙ-Д3 	 КАЛЬЦИЙ Д3 																							
 КО-ДИРОТОН 	 КО ДИРОТОН 																							
 КО-РЕНИТЕК 	 КО РЕНИТЕК 																							
 КО-ЭКСФОРЖ 	 КО ЭКСФОРЖ 																							
 Л-ТИРОКСИН 	 Л ТИРОКСИН 																							
 ЛОЗАРТАН-Н 	 ЛОЗАРТАН Н 																							
 ПУРИ-НЕТОЛ 	 ПУРИ НЕТОЛ 																							
 РЕВМА-ГЕЛЬ 	 РЕВМА ГЕЛЬ 																							
 РЕКИЦЕН-РД 	 РЕКИЦЕН РД 																							
 УРО-ВАКСОМ 	 УРО ВАКСОМ 																							
 УРОПРОСТ-Д 	 УРОПРОСТ Д 																							
 ФИБРО-ВЕЙН 	 ФИБРО ВЕЙН 																							
 ФИТО-СПЛАТ 	 ФИТО СПЛАТ 																							
 ЭНТЕГНИН-Н 	 ЭНТЕГНИН Н 																							
 ЭУФЛОРИН-B 	 ЭУФЛОРИН B 																							
 ЭУФЛОРИН-L 	 ЭУФЛОРИН L 																							
 БЕЗ САХАРА 	 Б/САХ 																							
БАЛЬЗАМ ГЕЛЬ	БАЛЬЗ ГЕЛЬ																							
БАЛЬЗАМ КРЕМ	БАЛЬЗ КРЕМ																							
ВАТНЫЕ ДИСКИ	ВАТ ДИСКИ																							
ВЕСЫ ДЕТСКИЕ	ВЕСЫ ДЕТ																							
ГЕЛЬ БАЛЬЗАМ	ГЕЛЬ БАЛЬЗ																							
ГЕЛЬ ГЛАЗНОЙ	ГЕЛЬ ГЛАЗ																							
ГЕЛЬ ДЛЯ НОГ	ГЕЛЬ Д/НОГ																							
ГЕЛЬ-БАЛЬЗАМ	ГЕЛЬ-БАЛЬЗ																							
ДЕТСКИЙ КРЕМ	ДЕТ КРЕМ																							
ЗУБНАЯ ПАСТА	ЗУБ ПАСТА																							
КАПЛИ ЗУБНЫЕ	КАП ЗУБ																							
КРЕМ-БАЛЬЗАМ	КР -БАЛЬЗ																							
КРЕМ БАЛЬЗАМ	КР БАЛЗ																							
КРЕМ ДЛЯ НОГ	КР Д/НОГ																							
КРЕМ ДЛЯ РУК	КР Д/РУК																							
КРЕМ ДЕТСКИЙ	КР ДЕТ																							
КРЕМ ДЛЯ НОГ	КРЕМ Д/НОГ																							
КРЕМ ДЛЯ РУК	КРЕМ Д/РУК																							
МАЗЬ ГЛАЗНАЯ	МАЗЬ ГЛАЗ																							
МАСЛО ЖИРНОЕ	МАСЛО ЖИР																							
ТЕСТ-КАССЕТА	ТЕСТ-КАС																							
ТЕСТ-ПОЛОСКИ	ТЕСТ-ПОЛОС																							
ТРАВА БРИКЕТ	ТР БРИК																							
 ДАВ (DOVE)  	 DOVE  																							
 АДОНИС-БРОМ 	 АДОНИС БРОМ 																							
 АЛЬФАДОЛ-СА 	 АЛЬФАДОЛ СА 																							
 АРТРО-АКТИВ 	 АРТРО АКТИВ 																							
 АРФАЗЕТИН-Э 	 АРФАЗЕТИН Э 																							
 БЕРЛИН-ХЕМИ 	 БЕРЛИН ХЕМИ 																							
 ГАЛИУМ-ХЕЛЬ 	 ГАЛИУМ ХЕЛЬ 																							
 КО-ВАМЛОСЕТ 	 КО ВАМЛОСЕТ 																							
 КО-ДАЛЬНЕВА 	 КО ДАЛЬНЕВА 																							
 КО-ПЕРИНЕВА 	 КО ПЕРИНЕВА 																							
 КРОМ-АЛЛЕРГ 	 КРОМ АЛЛЕРГ 																							
 МУЛЬТИ-ТАБС 	 МУЛЬТИ ТАБС 																							
 НЕО-АНГИН Н 	 НЕО АНГИН Н 																							
 НОВО-ПАССИТ 	 НОВО ПАССИТ 																							
 ОМЕГА 3-6-9 	 ОМЕГА 3 6 9 																							
 ПЕРТУССИН-Ч 	 ПЕРТУССИН Ч 																							
 РАМИПРИЛ-СЗ 	 РАМИПРИЛ СЗ 																							
 СЕЛЕН-АКТИВ 	 СЕЛЕН АКТИВ 																							
 СТ-МЕДИФАРМ 	 СТ МЕДИФАРМ 																							
 ТАЙМ-ФАКТОР 	 ТАЙМ ФАКТОР 																							
 ТИМОЛОЛ-МЭЗ 	 ТИМОЛОЛ МЭЗ 																							
 УРОНОРМИН-Ф 	 УРОНОРМИН Ф 																							
АРОМАМЕДАЛЬОН	АРОМАМЕДАЛ																							
БАЛЬЗАМ СУХОЙ	БАЛЬЗ СУХ																							
ВНУТРИВЕННОГО	В/М																							
ГАЗ СЖИЖЕННЫЙ	ГАЗ СЖИЖ																							
ГЕЛЬ ДЛЯ ДУША	ГЕЛЬ Д/ДУША																							
ГЕЛЬ ДЛЯ ЛИЦА	ГЕЛЬ Д/ЛИЦА																							
ГЕЛЬ ДЛЯ ТЕЛА	ГЕЛЬ Д/ТЕЛА																							
КАПЛИ ГЛАЗНЫЕ	КАП ГЛАЗ																							
капли глазные	КАП.ГЛ.																							
КАПЛИ ГЛАЗНЫЕ	КАПЛИ ГЛ																							
КАПЛИ ГЛАЗНЫЕ	КАПЛИ ГЛ.																							
КАПЛИ ГЛАЗНЫЕ	 КПЛ. ГЛ.																							
КАПЛИ ГЛАЗНЫЕ	 КАП. ГЛ.																							
КРЕМ ДЛЯ ГЛАЗ	КР Д/ГЛАЗ																							
КРЕМ ДЛЯ ЛИЦА	КР Д/ЛИЦА																							
КРЕМ ДЛЯ СТОП	КР Д/СТОП																							
КРЕМ ДЛЯ ТЕЛА	КР Д/ТЕЛА																							
КРЕМ ЗАЩИТНЫЙ	КР ЗАЩИТ																							
КРЕМ ДЛЯ ЛИЦА	КРЕМ Д/ЛИЦА																							
КРЕМ ДЛЯ СТОП	КРЕМ Д/СТОП																							
КРЕМ ДЛЯ ТЕЛА	КРЕМ Д/ТЕЛА																							
КРЕМ ЗАЩИТНЫЙ	КРЕМ ЗАЩИТ																							
МАСЛО ДЕТСКОЕ	МАСЛО ДЕТ																							
МАСЛО ТВЕРДОЕ	МАСЛО ТВЕРД																							
МАСЛО ЭФИРНОЕ	МАСЛО ЭФИР																							
ПИЛЮЛИ МЯГКИЕ	ПИЛ МЯГК																							
ПИЛЮЛИ МЯГКИЕ	ПИЛ МЯГКИЕ																							
ПЛОДЫ ЦЕЛЬНЫЕ	ПЛОДЫ ЦЕЛЬН																							
ПРОРЕЗЫВАТЕЛЬ	ПРОРЕЗ-ЛЬ																							
С ВИТАМИНОМ С	С ВИТ.С																							
СИРОП-БАЛЬЗАМ	СИР -БАЛЬЗ																							
СИРОП-БАЛЬЗАМ	СИР-БАЛЬЗ																							
 СУППОЗИТОРИИ	 СУПП.																							
СУХОЙ БАЛЬЗАМ	СУХ БАЛЬЗ																							
ТРАВА-ПОРОШОК	ТР-ПОР																							
ФИЛЬТР-ПАКЕТЫ	Ф/П																							
ФИЛЬТР-ПАКЕТЫ	Ф/ПАК																							
 БАМА (BAMA)  	 BAMA  																							
 СЕНИ (SENI)  	 SENI  																							
 ТЕНА (TENA)  	 TENA  																							
 5-ФТОРУРАЦИЛ 	 5 ФТОРУРАЦИЛ 																							
 БРОНХО-МУНАЛ 	 БРОНХО МУНАЛ 																							
 ВЕРАПАМИЛ-СЗ 	 ВЕРАПАМИЛ СЗ 																							
 ГИНО-ПЕВАРИЛ 	 ГИНО ПЕВАРИЛ 																							
 ДЕПО-ПРОВЕРА 	 ДЕПО ПРОВЕРА 																							
 КВЕТИАПИН-СЗ 	 КВЕТИАПИН СЗ 																							
 КЛИМАКТ-ХЕЛЬ 	 КЛИМАКТ ХЕЛЬ 																							
 КОЭНЗИМ Q-10 	 КОЭНЗИМ Q 10 																							
 ЛЮТЕИН-ФОРТЕ 	 ЛЮТЕИН ФОРТЕ 																							
 НЕБИВОЛОЛ-СЗ 	 НЕБИВОЛОЛ СЗ 																							
 НЕО-ПЕНОТРАН 	 НЕО ПЕНОТРАН 																							
 НО-ШПА ФОРТЕ 	 НО ШПА ФОРТЕ 																							
 ПИРАЦЕТАМ-СЗ 	 ПИРАЦЕТАМ СЗ 																							
 СУСТАНОН-250 	 СУСТАНОН 250 																							
 ТОРАСЕМИД-СЗ 	 ТОРАСЕМИД СЗ 																							
 ФЕЛОДИПИН-СЗ 	 ФЕЛОДИПИН СЗ 																							
 ФИЛЬТРУМ-СТИ 	 ФИЛЬТРУМ СТИ 																							
 ФЛЮКОЛДЕКС-Н 	 ФЛЮКОЛДЕКС Н 																							
 ФЛЮКОЛДЕКС-С 	 ФЛЮКОЛДЕКС С 																							
 ЦЕРВИКОН-ДИМ 	 ЦЕРВИКОН ДИМ 																							
 ЭМОКСИ-ОПТИК 	 ЭМОКСИ ОПТИК 																							
АНТИПЕРСПИРАНТ	АНТИПЕРСПИР																							
БАЛЬЗАМ ЖИДКИЙ	БАЛЬЗ ЖИДК																							
БАТОНЧИК-МЮСЛИ	БАТ-МЮСЛИ																							
БАТОНЧИК МЮСЛИ	БАТ МЮСЛИ																							
ВАТНЫЕ ПАЛОЧКИ	ВАТ ПАЛОЧ																							
ГЕЛЬ ДЛЯ ДЕТЕЙ	ГЕЛЬ Д/ДЕТ																							
ГЕЛЬ НАЗАЛЬНЫЙ	ГЕЛЬ НАЗ																							
ГРАНУЛЫ МЯГКИЕ	ГРАН МЯГК																							
ГРАНУЛЫ МЯГКИЕ	ГРАН МЯГКИЕ																							
КАПСУЛЫ МЯГКИЕ	КАПС МЯГК																							
КАПСУЛЫ МЯГКИЕ	КАПС МЯГКИЕ																							
КАПСУЛЫ РЕТАРД	КАПС РЕТ																							
КАПСУЛЫ МЯГКИЕ	КАПСУЛЫ МЯГК																							
КРЕМ МАССАЖНЫЙ	КР МАССАЖ																							
КРЕМ МАССАЖНЫЙ	КР МАССАЖНЫЙ																							
КРЕМ НАЗАЛЬНЫЙ	КР НАЗ																							
КРЕМ НАЗАЛЬНЫЙ	КР НАЗ-Й																							
КРЕМ НАЗАЛЬНЫЙ	КРЕМ НАЗ																							
ЛАК ДЛЯ НОГТЕЙ	ЛАК Д/НОГТ																							
МАЗЬ НАЗАЛЬНАЯ	МАЗЬ НАЗ																							
МОЛОЧНАЯ СМЕСЬ	МОЛ СМЕСЬ																							
НИТЬ ДЛЯ ЗУБОВ	НИТЬ Д/ ЗУБОВ																							
НИТЬ ДЛЯ ЗУБОВ	НИТЬ Д/ЗУБ																							
НИТЬ ДЛЯ ЗУБОВ	НИТЬ Д/ЗУБОВ																							
ПЛЕНКИ ГЛАЗНЫЕ	ПЛ ГЛАЗ																							
ПЛЕНКИ ГЛАЗНЫЕ	ПЛЕНКИ ГЛАЗ																							
СМЕСЬ МОЛОЧНАЯ	СМЕСЬ МОЛОЧ																							
СПРЕЙ ОРАЛЬНЫЙ	СПР ОРАЛ																							
 СУППОЗИТОРИИ 	 СУПП 																							
ЦВЕТКИ ПОРОШОК	ЦВ ПОР																							
ЭКСТРАКТ СУХОЙ	ЭКСТР СУХОЙ																							
 АВЕН (AVENE)  	 AVENE  																							
 СТИКС (STYX)  	 STYX  																							
 ВИШИ (VICHY)  	 VICHY  																							
 АКВА-РИНОСОЛЬ 	 АКВА РИНОСОЛЬ 																							
 АЛКА-ЗЕЛЬТЦЕР 	 АЛКА ЗЕЛЬТЦЕР 																							
 АСЕПТИСОРБ-ДТ 	 АСЕПТИСОРБ ДТ 																							
 АЦИДИН-ПЕПСИН 	 АЦИДИН ПЕПСИН 																							
 БРОНХО-ВАКСОМ 	 БРОНХО ВАКСОМ 																							
 ГИПРОМЕЛОЗА-П 	 ГИПРОМЕЛОЗА П 																							
 ИВАН-ДА-МАРЬЯ 	 ИВАН ДА МАРЬЯ 																							
 ЙОД-АКТИВ 100 	 ЙОД АКТИВ 100 																							
 МЕН-С ФОРМУЛА 	 МЕН С ФОРМУЛА 																							
 НОРМОФЛОРИН-Д 	 НОРМОФЛОРИН Д 																							
 НОРМОФЛОРИН-Л 	 НОРМОФЛОРИН Л 																							
 ПРОПРОТЕН-100 	 ПРОПРОТЕН 100 																							
 ПРОТАРГОЛ-ЛОР 	 ПРОТАРГОЛ ЛОР 																							
 ПСИЛО-БАЛЬЗАМ 	 ПСИЛО БАЛЬЗАМ 																							
 РАБЕПРАЗОЛ-СЗ 	 РАБЕПРАЗОЛ СЗ 																							
 РИСПЕРИДОН-СЗ 	 РИСПЕРИДОН СЗ 																							
 СИЛДЕНАФИЛ-СЗ 	 СИЛДЕНАФИЛ СЗ 																							
 ЭЛИЦЕЯ КУ-ТАБ 	 ЭЛИЦЕЯ КУ ТАБ 																							
 ЭНАЛАПРИЛ-ФПО 	 ЭНАЛАПРИЛ ФПО 																							
 ЭТОПОЗИД-ТЕВА 	 ЭТОПОЗИД ТЕВА 																							
БАЛЬЗАМ ДЛЯ ГУБ	БАЛЬЗ Д/ ГУБ																							
ВНУТРИМЫШЕЧНОГО	В/В																							
ГЕЛЬ ДЛЯ БРИТЬЯ	ГЕЛЬ Д/БРИТЬЯ																							
ГОРЧИЧНИК-ПАКЕТ	ГОРЧИЧ -ПАК																							
КАПЛИ НАЗАЛЬНЫЕ	КАП НАЗ																							
КАПЛИ НАЗАЛЬНЫЕ	КАП НАЗЬНЫЕ																							
капли назальные	 КАПЛИ НАЗ 																							
капли назальные	 КАПЛИ НАЗ.																							
капли назальные	кпл. Наз.																							
КРЕМ-РАСТИРАНИЕ	КР -РАСТИР																							
КРЕМ-РАСТИРАНИЕ	КР -РАСТИРАНИЕ																							
КРЕМ РЕКТАЛЬНЫЙ	КР РЕКТ																							
МАЗЬ РЕКТАЛЬНАЯ	МАЗЬ РЕКТ																							
МАСКА ДЛЯ ВОЛОС	МАСКА Д/ВОЛОС																							
МАСЛО МАССАЖНОЕ	МАСЛО МАССАЖ																							
ПАКЕТ-ГОРЧИЧНИК	ПАК -ГОРЧИЧ																							
ПАСТА ДЛЯ СТОМЫ	ПАСТА Д/СТОМЫ																							
ПЕНКА ОЧИЩАЮЩАЯ	ПЕНКА ОЧИЩ																							
ПЛАСТИНА ЗУБНАЯ	ПЛАСТ ЗУБ																							
ПЛАСТИНА ЗУБНАЯ	ПЛАСТИНА ЗУБ																							
СПРЕЙ ДЛЯ ГОРЛА	СПР Д/ ГОРЛА																							
СПРЕЙ ДЛЯ ГОРЛА	СПР Д/ГОРЛА																							
СПРЕЙ НАЗАЛЬНЫЙ	СПР НАЗ																							
спрей назальный	СПР. НАЗ.																							
спрей назальный	СПРЕЙ НАЗ																							
СПРЕЙ НАЗАЛЬНЫЙ	СПРЕЙ НАЗАЛЬН.																							
ЖИДКИЙ ЭКСТРАКТ	ЭКСТР ЖИД																							
 ДЕНИК (DENIQ)  	 DENIQ  																							
 ЭУРОН (EURON)  	 EURON  																							
 ЛАЙКА (LAICA)  	 LAICA  																							
 МЕДУС (MEDUS)  	 MEDUS  																							
 ОМРОН (OMRON)  	 OMRON  																							
 ОПТИО (OPTIO)  	 OPTIO  																							
 АМИОДАРОН-АКРИ 	 АМИОДАРОН АКРИ 																							
 АМЛОДИПИН-ТЕВА 	 АМЛОДИПИН ТЕВА 																							
 АНАЛЬГИН-ХИНИН 	 АНАЛЬГИН ХИНИН 																							
 АНГЕЛИКА-ФОРТЕ 	 АНГЕЛИКА ФОРТЕ 																							
 БРОНХАЛИС-ХЕЛЬ 	 БРОНХАЛИС ХЕЛЬ 																							
 БУСЕРЕЛИН-ЛОНГ 	 БУСЕРЕЛИН ЛОНГ 																							
 ВЕРАПАМИЛ-ЛЕКТ 	 ВЕРАПАМИЛ ЛЕКТ 																							
 ВИНПОЦЕТИН-OBL 	 ВИНПОЦЕТИН OBL 																							
 ЗАЛАСТА КУ-ТАБ 	 ЗАЛАСТА КУ ТАБ 																							
 КО-ТРИМОКСАЗОЛ 	 КО ТРИМОКСАЗОЛ 																							
 ЛЕДИ-С ФОРМУЛА 	 ЛЕДИ С ФОРМУЛА 																							
 МЕТРОМИКОН-НЕО 	 МЕТРОМИКОН НЕО 																							
 МЕТФОРМИН-ТЕВА 	 МЕТФОРМИН ТЕВА 																							
 МИЦЕЛЛАТ-АКТИВ 	 МИЦЕЛЛАТ АКТИВ 																							
 ПЕРИНДОПРИЛ-СЗ 	 ПЕРИНДОПРИЛ СЗ 																							
 РАНИТИДИН-ЛЕКТ 	 РАНИТИДИН ЛЕКТ 																							
 СУПРИМА-БРОНХО 	 СУПРИМА БРОНХО 																							
 ТИЗАНИДИН-ТЕВА 	 ТИЗАНИДИН ТЕВА 																							
 ФАМОТИДИН-АКОС 	 ФАМОТИДИН АКОС 																							
 ФУЗИДИН-НАТРИЯ 	 ФУЗИДИН НАТРИЯ 																							
 ЦИСПЛАТИН-ЛЭНС 	 ЦИСПЛАТИН ЛЭНС 																							
БАЛЬЗАМ ДЛЯ ТЕЛА	БАЛЬЗ Д/ТЕЛА																							
ГЕЛЬ ВАГИНАЛЬНЫЙ	ГЕЛЬ ВАГ																							
ГЕЛЬ ВАГИНАЛЬНЫЙ	ГЕЛЬ ВАГИНАЛЬНЫЙ																							
ГОРЧИЧНИК ПАКЕТЫ	ГОРЧИЧ ПАК																							
ГУБКА СКРУЧЕННАЯ	ГУБКА СКРУЧ																							
ДЕЗОДОРАНТ-СПРЕЙ	ДЕЗОДОР -СПР																							
КАША БЕЗМОЛОЧНАЯ	КАША Б/М																							
КОРРЕКТОР ОСАНКИ	КОР-Р ОСАНКИ																							
КРЕМ ВАГИНАЛЬНЫЙ	КР ВАГ																							
КРЕМ ВАГИНАЛЬНЫЙ	КР ВАГИН																							
КРЕМ ФИКСИРУЮЩИЙ	КР ФИКС																							
КРЕМ ВАГИНАЛЬНЫЙ	КРЕМ ВАГ																							
КРЕМ ВАГИНАЛЬНЫЙ	КРЕМ ВАГИН																							
ЛИНЗЫ КОНТАКТНЫЕ	ЛИНЗЫ КОНТАКТ																							
МАЗЬ ОТ НАСМАРКА	МАЗЬ ОТ НАСМОРКА																							
МИНЕРАЛЬНАЯ ВОДА	МИН ВОДА																							
МИНЕРАЛЬНАЯ ВОДА	МИНЕР ВОДА																							
МОЛОЧКО ДЛЯ ТЕЛА	МОЛОЧКО Д/ТЕЛА																							
НАБОР МАНИКЮРНЫЙ	НАБОР МАНИКЮР																							
ПАСТА ОТ ПЕРХОТИ	ПАСТА ОТ ПЕРХ																							
ПРИСЫПКА ДЕТСКАЯ	ПРИСЫП ДЕТ																							
РАСТВОР МАСЛЯНЫЙ	Р-Р МАСЛ																							
САЛФЕТКИ ВЛАЖНЫЕ	САЛФ ВЛАЖ																							
СКРУЧЕННАЯ ГУБКА	СКРУЧ ГУБКА																							
таблетки шипучие	ТАБ.ШИП.																							
ЧЕРНАЯ СМОРОДИНА	Ч.СМОР																							
 А-ТЕКС (A-TEX)  	 A-TEX  																							
 АПРИКС (APRIX)  	 APRIX  																							
 КАРЕКС (CAREX)  	 CAREX  																							
 ЧИККО (CHICCO)  	 CHICCO  																							
 ЭНШУР (ENSURE)  	 ENSURE  																							
 УРЬЯЖ (URIAGE)  	 URIAGE  																							
 ВЕЛЕДА (WELEDA) 	 WELEDA 																							
 АНАСТРОЗОЛ-ТЕВА 	 АНАСТРОЗОЛ ТЕВА 																							
 БИОВЕСТИН-ЛАКТО 	 БИОВЕСТИН ЛАКТО 																							
 ВИЗАРСИН КУ-ТАБ 	 ВИЗАРСИН КУ ТАБ 																							
 ДОМПЕРИДОН-ТЕВА 	 ДОМПЕРИДОН ТЕВА 																							
 ЛИНКОМИЦИН-АКОС 	 ЛИНКОМИЦИН АКОС 																							
 ЛЮТЕИН-ИНТЕНСИВ 	 ЛЮТЕИН ИНТЕНСИВ 																							
 ЛЮТЕИН-КОМПЛЕКС 	 ЛЮТЕИН КОМПЛЕКС 																							
 МЕЛОКСИКАМ-ТЕВА 	 МЕЛОКСИКАМ ТЕВА 																							
 МЕСТАМИДИН-СЕНС 	 МЕСТАМИДИН СЕНС 																							
 ПРОКТО-ГЛИВЕНОЛ 	 ПРОКТО ГЛИВЕНОЛ 																							
 ПРОПОФОЛ-ЛИПУРО 	 ПРОПОФОЛ ЛИПУРО 																							
 РОЗУВАСТАТИН-СЗ 	 РОЗУВАСТАТИН СЗ 																							
 ФЕРОГЛОБИН-В 12 	 ФЕРОГЛОБИН В 12 																							
 ФЛИТ ФОСФО-СОДА 	 ФЛИТ ФОСФО СОДА 																							
 ЦИКЛО-ПРОГИНОВА 	 ЦИКЛО ПРОГИНОВА 																							
БАЛЬЗАМ ДЛЯ ВОЛОС	БАЛЬЗ Д/ВОЛОС																							
ДЛЯ ПРИЕМА ВНУТРЬ	Д/ПРИЕМА ВНУТРЬ																							
КАПЛИ ПОДЪЯЗЫЧНЫЕ	КАП ПОДЪЯЗ																							
МАСКА МЕДИЦИНСКАЯ	МАСКА МЕДИЦ.																							
ПОРОШОК ДЛЯ ДЕТЕЙ	ПОР Д/ДЕТ																							
РАСТВОР СПИРТОВОЙ	Р-Р СПИРТ																							
СБОР ИЗМЕЛЬЧЕННЫЙ	СБОР ИЗМЕЛЬЧ																							
СУСПЕНЗИЯ ГЛАЗНАЯ	СУСП ГЛАЗ																							
СУСПЕНЗИЯ ГЛАЗНАЯ	СУСП. ГЛ.																							
 ТАБЛЕТКИ РЕТАРД 	 ТАБ РЕТ 																							
ФЛАКОН-КАПЕЛЬНИЦА	ФЛ-КАП																							
ШАМП -КОНДИЦИОНЕР	ШАМП -КОНДИЦ																							
ШАМПУНЬ ДЛЯ ВОЛОС	ШАМП Д/ВОЛОС																							
ЭКСТРАКТ МАСЛЯНЫЙ	ЭКСТР МАСЛ																							
 АНСВЕР (ANSWER)  	 ANSWER  																							
 АНТРАЛ (ANTRAL)  	 ANTRAL  																							
 АТТЕСТ (ATTEST)  	 ATTEST  																							
 БАДОЛА (BADOLA)  	 BADOLA  																							
 СИ ТЕКС (C TEX)  	 C TEX  																							
 ДЕПЕНД (DEPEND)  	 DEPEND  																							
 ХАСИКО (HASICO)  	 HASICO  																							
 КИМОНО (KIMONO)  	 KIMONO  																							
 КИНДЕР (KINDER)  	 KINDER  																							
 ЛЮКСАН (LUXSAN)  	 LUXSAN  																							
 СПАРТА (SPARTA)  	 SPARTA  																							
 ТЕРЕЗА (TEREZA)  	 TEREZA  																							
 Л/П УРГО (URGO)  	 URGO  																							
 ВОНАМИ (WANAME)  	 WANAME  																							
 АНТИГРИППИН-АНВИ 	 АНТИГРИППИН АНВИ 																							
 ДЕКСА-ГЕНТАМИЦИН 	 ДЕКСА ГЕНТАМИЦИН 																							
 КЛОПИКСОЛ-АКУФАЗ 	 КЛОПИКСОЛ АКУФАЗ 																							
 МАГНИЙ-ДИАСПОРАЛ 	 МАГНИЙ ДИАСПОРАЛ 																							
 МАСТИОЛ ЭДАС-927 	 МАСТИОЛ ЭДАС 927 																							
 МЕЛОКСИКАМ-ПРАНА 	 МЕЛОКСИКАМ ПРАНА 																							
 МЕРОПЕНЕМ-ЛЕКСВМ 	 МЕРОПЕНЕМ ЛЕКСВМ 																							
 ПЕФЛОКСАЦИН-АКОС 	 ПЕФЛОКСАЦИН АКОС 																							
 САЛТИКАЗОН-НАТИВ 	 САЛТИКАЗОН НАТИВ 																							
 САНДИММУН-НЕОРАЛ 	 САНДИММУН НЕОРАЛ 																							
 ФЕНИЛЭФРИН-ОПТИК 	 ФЕНИЛЭФРИН ОПТИК 																							
 ФОРМИСОНИД-НАТИВ 	 ФОРМИСОНИД НАТИВ 																							
 ЭРИТРОМИЦИН-ЛЕКТ 	 ЭРИТРОМИЦИН ЛЕКТ 																							
 L-ЛИЗИНА ЭСЦИНАТ 	 L ЛИЗИНА ЭСЦИНАТ 																							
АЭРОЗОЛЬ НАЗАЛЬНЫЙ	АЭРОЗ НАЗ 																							
БРАСЛЕТ ОТ КОМАРОВ	БРАСЛ ОТ КОМАР																							
КАПСУЛЫ РЕКТАЛЬНЫЕ	КАПС РЕКТ																							
КАПСУЛЫ РЕКТАЛЬНЫЕ	КАПСУЛЫ РЕКТ																							
кишечнорастворимые	КИШЕЧНОР																							
КОЛЬЦО ВАГИНАЛЬНОЕ	КОЛЬЦО ВАГ																							
КРЕМ РАЗОГРЕВАЮЩИЙ	КР РАЗОГРЕВ																							
КРЕМ РАЗОГРЕВАЮЩИЙ	КР РАЗОГРЕВАЮЩИЙ																							
КРЕМ РАЗОГРЕВАЮЩИЙ	КРЕМ РАЗОГРЕВ																							
ЛЕДЕНЦЫ БЕЗ САХАРА	ЛЕД Б/САХ																							
ПАСТИЛКИ (ЯГОДНЫЕ)	ПАСТ (ЯГОД)																							
ПАСТИЛКИ ФРУКТОВЫЕ	ПАСТ ФРУКТ																							
ПАСТИЛКИ ФРУКТОВЫЕ	ПАСТ ФРУКТОВЫЕ																							
РАСТВОР ДЛЯ МУЖЧИН	Р-Р Д/ МУЖ																							
РАСТВОР ДЛЯ МУЖЧИН	Р-Р Д/МУЖ																							
РАСТВОР РЕКТАЛЬНЫЙ	Р-Р РЕКТ																							
СПРЕЙ ДОЗИРОВАННЫЙ	СПР ДОЗ																							
СЫРЬЕ РАСТИТЕЛЬНОЕ	СЫРЬЕ РАСТИТ																							
 ТАБЛЕТКИ ШИПУЧИЕ 	 ТАБ ШИП 																							
ТРАВА ИЗМЕЛЬЧЕННАЯ	ТР ИЗМЕЛЬЧ																							
 БИ ВЕЛЛ (B.WELL)  	 B.WELL  																							
 БЮБХЕН (BUBCHEN)  	 BUBCHEN  																							
 КОМПИД (COMPEED)  	 COMPEED  																							
 ФРЕНЧИ (FRENCHI)  	 FRENCHI  																							
 ФИЛИПС (PHILIPS)  	 PHILIPS  																							
 АКВАМАРИН ОМЕГА-3 	 АКВАМАРИН ОМЕГА 3 																							
 АЦИКЛОВИР-АКРИХИН 	 АЦИКЛОВИР АКРИХИН 																							
 ВЕРО-ТРИМЕТАЗИДИН 	 ВЕРО ТРИМЕТАЗИДИН 																							
 ЗАНИДИП-РЕКОРДАТИ 	 ЗАНИДИП РЕКОРДАТИ 																							
 МЕТОТРЕКСАТ-ЭБЕВЕ 	 МЕТОТРЕКСАТ ЭБЕВЕ 																							
 МЕТРОНИДАЗОЛ-АКОС 	 МЕТРОНИДАЗОЛ АКОС 																							
 МЕТФОРМИН МВ-ТЕВА 	 МЕТФОРМИН МВ ТЕВА 																							
 МУЛЬТИ-ТАБС МАЛЫШ 	 МУЛЬТИ ТАБС МАЛЫШ 																							
 МУЛЬТИ-ТАБС ЮНИОР 	 МУЛЬТИ ТАБС ЮНИОР 																							
 ЦЕТИРИЗИН-АКРИХИН 	 ЦЕТИРИЗИН АКРИХИН 																							
 ЦЕФОТАКСИМ-ЛЕКСВМ 	 ЦЕФОТАКСИМ ЛЕКСВМ 																							
 ЭНАЛАПРИЛ-АКРИ НЛ 	 ЭНАЛАПРИЛ АКРИ НЛ 																							
АНТИПЕРСПИРАНТ СТИК	АНТИПЕРСПИР СТИК																							
АСПИРАТОР НАЗАЛЬНЫЙ	АСПИР НАЗ																							
ВКЛАДЫШ-ПОДПЯТОЧНИК	 ВКЛАД -ПОДПЯТОЧ																							
ЖЕВАТЕЛЬНАЯ РЕЗИНКА	ЖЕВАТ РЕЗ																							
ЗУБНАЯ ЩЕТКА МЯГКАЯ	ЗУБ ЩЕТКА МЯГК																							
КАПЛИ ДЛЯ ИНГАЛЯЦИЙ	КАП Д/ИНГ																							
КАПСУЛЫ ВАГИНАЛЬНЫЕ	КАПС ВАГ																							
КАПСУЛЫ ВАГИНАЛЬНЫЕ	КАПС ВАГИНАЛЬНЫЕ																							
КАПСУЛЫ ЖЕВАТЕЛЬНЫЕ	КАПС ЖЕВАТ																							
КАПСУЛЫ ЖЕЛАТИНОВЫЕ	КАПС ЖЕЛАТ																							
КАПСУЛЫ ПОДЪЯЗЫЧНЫЕ	КАПС П/ЯЗ																							
КАПСУЛЫ ПОДЪЯЗЫЧНЫЕ	КАПС ПОДЪЯЗЫЧ																							
КАПСУЛЫ ПОДЪЯЗЫЧНЫЕ	КАПС ПОДЪЯЗЫЧНЫЕ																							
КАПСУЛЫ ПОДЪЯЗЫЧНЫЕ	КАПСУЛЫ ПОДЪЯЗ																							
КОЛЬЦО ВИБРАЦИОННОЕ	КОЛЬЦО ВИБР																							
КОНФЕТА ЖЕВАТЕЛЬНАЯ	КОНФ ЖЕВ																							
КОНФЕТА ЖЕВАТЕЛЬНАЯ	КОНФ ЖЕВАТ-Я																							
КОНФЕТА ЖЕВАТЕЛЬНАЯ	КОНФЕТА ЖЕВ																							
КРЕМ-ГЕЛЬ МАССАЖНЫЙ	КР -ГЕЛЬ МАССАЖ																							
КРЕМ АНТИВАРИКОЗНЫЙ	КР А/ВАРИКОЗ																							
КРЕМ АНТИВАРИКОЗНЫЙ	КР АНТИВАРИКОЗ																							
КРЕМ-ГЕЛЬ МАССАЖНЫЙ	КР-ГЕЛЬ МАССАЖ																							
КРЕМ АНТИВАРИКОЗНЫЙ	КРЕМ АНТИВАР																							
МАСЛО ДЛЯ ИНГАЛЯЦИЙ	МАСЛО Д/ИНГ																							
мосхимфармпрепараты	МХФ																							
ПАСТИЛКИ (ЛИМОННЫЕ)	ПАСТ (ЛИМОН)																							
ПАСТИЛКИ БЕЗ САХАРА	ПАСТ Б/САХ																							
ПЕЛЕНКИ ВПИТЫВАЮЩИЕ	ПЕЛЕНК ВПИТ																							
ПОРОШОК РАСТВОРИМЫЙ	ПОР РАСТВ																							
ПОРОШОК РАСТВОРИМЫЙ	ПОР РАСТВ-Й																							
ПОРОШОК ФИКСИРУЮЩИЙ	ПОР ФИКС																							
РАСТВОР ВАГИНАЛЬНЫЙ	Р-Р ВАГ																							
РАСТВОР ДЛЯ ИНФУЗИЙ	Р-Р Д/ ИНФ																							
РАСТВОР ДЛЯ ИНФУЗИЙ	Р-Р Д/ИНФ																							
РАСТВОР ДЛЯ ИНФУЗИЙ	Р-Р Д/ИНФ.																							
САЛФЕТКИ СТЕРИЛЬНЫЕ	САЛФ СТЕР																							
СПРЕЙ Д/ГОРЛА ДОЗИР	СПР Д/ГОРЛА ДОЗ																							
 ТАБЛЕТКИ ЗАЩЕЧНЫЕ 	 ТАБ ЗАЩЕЧ 																							
 ТАБЛЕТКИ ЩЕЛОЧНЫЕ 	 ТАБ ЩЕЛОЧ 																							
ЦВЕТКИ ИЗМЕЛЬЧЕННЫЕ	ЦВ ИЗМЕЛЬЧ																							
 БИОКАРД (BIOCARD)  	 BIOCARD  																							
 ЭМОЛИУМ (EMOLIUM)  	 EMOLIUM  																							
 ФИЛОРГА (FILORGA)  	 FILORGA  																							
 ФЛУФСАН (FLUFSAN)  	 FLUFSAN  																							
 ГАЛЕНИК (GALENIC)  	 GALENIC  																							
 МОЛИМЕД (MOLIMED)  	 MOLIMED  																							
 МОЛИНЕА (MOLINEA)  	 MOLINEA  																							
 НЕКСКЕА (NEXCARE)  	 NEXCARE  																							
 ОКАМОТО (OKAMOTO)  	 OKAMOTO  																							
 ПЛЭЙБОЙ (PLAYBOY)  	 PLAYBOY  																							
 ПРОБЭБИ (PROBABY)  	 PROBABY  																							
 С-ПЛАСТ (S-PLAST)  	 S-PLAST  																							
 САНОСАН (SANOSAN)  	 SANOSAN  																							
 АНТИ-АНГИН ФОРМУЛА 	 АНТИ АНГИН ФОРМУЛА 																							
 АЦЕТИЛЦИСТЕИН-ТЕВА 	 АЦЕТИЛЦИСТЕИН ТЕВА 																							
 БЕРБЕРИС-ГОМАККОРД 	 БЕРБЕРИС ГОМАККОРД 																							
 КАЛЬЦИЙ-Д3 НИКОМЕД 	 КАЛЬЦИЙ Д3 НИКОМЕД 																							
 ТОНЗИЛЛИН ЭДАС-125 	 ТОНЗИЛЛИН ЭДАС 125 																							
АНТИПЕРСПИРАНТ РОЛИК	АНТИПЕРСПИР РОЛ																							
АНТИПЕРСПИРАНТ ШАРИК	АНТИПЕРСПИР ШАР																							
АРОМАТИЗАТОР ВОЗДУХА	АРОМАТИЗАТОР ВОЗД																							
БАНДАЖ АБДОМИНАЛЬНЫЙ	БАНД АБДОМ																							
ГЕЛЬ ТРАНСДЕРМАЛЬНЫЙ	ГЕЛЬ ТРАНСДЕРМ																							
ДЕЗОДОРАНТ РОЛИКОВЫЙ	ДЕЗОДОР РОЛ																							
ДЕЗОДОРАНТ ШАРИКОВЫЙ	ДЕЗОДОР ШАР																							
ЗУБНАЯ ЩЕТКА СРЕДНЯЯ	ЗУБ ЩЕТКА СРЕД																							
КРЕМ-БАЛЬЗАМ ДЛЯ ВЕН	КР -БАЛЬЗ Д/ ВЕН																							
КРЕМ-БАЛЬЗАМ ДЛЯ НОГ	КР -БАЛЬЗ Д/ НОГ																							
КРЕМ-БАЛЬЗАМ ДЛЯ ВЕН	КР -БАЛЬЗ Д/ВЕН																							
КРЕМ-БАЛЬЗАМ ДЛЯ НОГ	КР -БАЛЬЗ Д/НОГ																							
КРЕМ ДЛЯ ЛИЦА И ТЕЛА	КР Д/ЛИЦА/ТЕЛА																							
КРЕМ СО ЗМЕИНЫМ ЯДОМ	КР СО ЗМЕИН ЯД																							
КРЕМ СО ЗМЕИНЫМ ЯДОМ	КР СО ЗМЕИНЫМ ЯДОМ																							
МАРМЕЛАД ЖЕВАТЕЛЬНЫЙ	МАРМЕЛ ЖЕВАТ																							
МАРМЕЛАД ЖЕВАТЕЛЬНЫЙ	МАРМЕЛАД ЖЕВАТ																							
МАСЛО ЖИРНОЕ ТВЕРДОЕ	МАСЛО ЖИР ТВЕРД																							
НАРУЖНОГО ПРИМЕНЕНИЯ	НАРУЖ.ПРИМ.																							
ОБУВЬ ОРТОПЕДИЧЕСКАЯ	ОБУВЬ ОРТОПЕД																							
ПАСТИЛКИ (МАЛИНОВЫЕ)	ПАСТ (МАЛИН)																							
ПАСТИЛКИ (ФРУКТОВЫЕ)	ПАСТ (ФРУКТ)																							
ПАСТИЛКИ ЖЕВАТЕЛЬНЫЕ	ПАСТ ЖЕВ																							
ПАСТИЛКИ ЖЕВАТЕЛЬНЫЕ	ПАСТ ЖЕВАТ																							
пастилки жевательные	ПАСТ.ЖЕВ.																							
ПОРОШОК ДЛЯ ВЗРОСЛЫХ	ПОР Д/ВЗРОСЛ																							
ПОРОШОК ДЛЯ ВЗРОСЛЫХ	ПОР Д/ВЗРОСЛЫХ																							
ПОРОШОК ДЛЯ ИНЪЕКЦИЙ	ПОР Д/ИН																							
ПОРОШОК ДОЗИРОВАННЫЙ	ПОР ДОЗ																							
ПРОКЛАДКИ ЕЖЕДНЕВНЫЕ	ПРОКЛ ЕЖЕДНЕВ																							
РАСТВОР ДЛЯ ИНЪЕКЦИЙ	Р-Р Д/ ИН																							
РАСТВОР ДЛЯ ПЕРФУЗИЙ	Р-Р Д/ ПЕРФУЗ																							
РАСТВОР ДЛЯ ИНЪЕКЦИЙ	Р-Р Д/ИН																							
РАСТВОР ДЛЯ ИНЪЕКЦИЙ	Р-Р Д/ИН.																							
РАСТВОР ДЛЯ ИНЪЕКЦИЙ	Р-Р Д/ИНЪ																							
РАСТВОР ДЛЯ ПЕРФУЗИЙ	Р-Р Д/ПЕРФУЗ																							
РАСТВОР ДОЗИРОВАННЫЙ	Р-Р ДОЗ																							
РАСТВОР ЛАБОРАТОРНЫЙ	Р-Р ЛАБ																							
СУСПЕНЗИЯ РЕКТАЛЬНАЯ	СУСП РЕКТ																							
 ТАБЛЕТКИ ДЛЯ ДЕТЕЙ 	 ТАБ Д/ДЕТ 																							
 ТАБЛЕТКИ ДЛЯ ДЕТЕЙ 	 ТАБ ДЕТ 																							
 ТАБЛЕТКИ ФРУКТОВЫЕ 	 ТАБ ФРУКТ 																							
таблетки жевательные	ТАБ.ЖЕВ.																							
таблетки растворимые	ТАБ.РАСТВ.																							
ТАБЛЕТКИ ЖЕВАТЕЛЬНЫЕ	ТБЛ ЖЕВАТ																							
ТАБЛЕТКИ ПОДЪЯЗЫЧНЫЕ	ТБЛ ПОДЪЯЗ																							
таблетки растворимые	ТБЛ РАСТВ																							
ТАБЛЕТКИ РАСТВОРИМЫЕ	ТБЛ РАСТВ.																							
ЭМУЛЬСИЯ ДЛЯ ИНФУЗИЙ	ЭМУЛЬС Д/ИНФ																							
 ЭЙР ПЛЮС (AIRPLUS)  	 AIRPLUS  																							
 АМНИШУР (AMNISURE)  	 AMNISURE  																							
 АПЕКСМЕД (APEXMED)  	 APEXMED  																							
 ЭЛАНСИЛЬ (ELANCYL)  	 ELANCYL  																							
 ВАЗОТОН (L-АРГИНИН) 	 ВАЗОТОН (L АРГИНИН) 																							
 ИНТЕСТИ-БАКТЕРИОФАГ 	 ИНТЕСТИ БАКТЕРИОФАГ 																							
 КОНВУЛЬСОФИН-РЕТАРД 	 КОНВУЛЬСОФИН РЕТАРД 																							
 ЛЕВЕТИРАЦЕТАМ-КАНОН 	 ЛЕВЕТИРАЦЕТАМ КАНОН 																							
 РАСТОРОПША-ПАРАФАРМ 	 РАСТОРОПША ПАРАФАРМ 																							
КАПЛИ ГЛАЗНЫЕ И УШНЫЕ	КАП ГЛАЗ И УШ																							
КАПЛИ ГЛАЗНЫЕ И УШНЫЕ	КАП ГЛАЗ/УШ																							
КАПЛИ ГОМЕОПАТИЧЕСКИЕ	КАП ГОМЕОПАТ																							
КАПСУЛЫ ДЛЯ ИНГАЛЯЦИЙ	КАПС Д/ИНГ																							
КРЕМ ДЛЯ КОНТУРА ГЛАЗ	КР Д/КОНТУРА ГЛАЗ																							
КРЕМ ДЛЯ РУК И НОГТЕЙ	КР Д/РУК/НОГТ																							
МАСЛО ГОМЕОПАТИЧЕСКОЕ	МАСЛО ГОМЕОПАТ																							
МАСЛО ДЛЯ КУРИЛЬЩИКОВ	МАСЛО Д/КУРИЛЬЩ																							
ПАСТИЛКИ (АНАНАСОВЫЕ)	ПАСТ (АНАНАС)																							
ПАСТИЛКИ (КЛУБНИЧНЫЕ)	ПАСТ (КЛУБ)																							
ПАСТИЛКИ ОРИГИНАЛЬНЫЕ	ПАСТ ОРИГИНАЛ																							
ПОРОШОК ДЛЯ ИНГАЛЯЦИЙ	ПОР Д/ИНГ																							
ПОРОШОК ДЛЯ ИНГАЛЯЦИЙ	ПОР. Д/ИН.																							
ПОРОШОК ДЛЯ ИНГАЛЯЦИЙ	ПОР. Д/ИН.																							
ПРОКЛАДКИ ФИКСИРУЮЩИЕ	ПРОКЛ ФИКС																							
РАСТВОР ДЛЯ ИНГАЛЯЦИЙ	Р-Р Д/ ИНГ																							
РАСТВОР ДЛЯ ИНГАЛЯЦИЙ	Р-Р Д/ИНГ																							
РАСТВОР-КАПЛИ ГЛАЗНЫЕ	Р-Р-КАП ГЛАЗ																							
 ТАБЛЕТКИ-ЛИОФИЛИЗАТ 	 ТАБ -ЛИОФИЛ 																							
ШАМПУНЬ ЛЕКАРСТВЕННЫЙ	ШАМП ЛЕК																							
 АНТИФЬЮМ (ANTIFUME)  	 ANTIFUME  																							
 БЭБИЛАЙН (BABYLINE)  	 BABYLINE  																							
 БИОДЕРМА (BIODERMA)  	 BIODERMA  																							
 КАЗАНОВА (CASANOVA)  	 CASANOVA  																							
 ЦЕЛАПРОП (CELAPROP)  	 CELAPROP  																							
 ФЕРСТЭЙД (FIRSTAID)  	 FIRSTAID  																							
 АЙДИ КЕАР (ID CARE)  	 ID CARE  																							
 МИЛАТЕСТ (MILATEST)  	 MILATEST  																							
 МОЛИКЕАР (MOLICARE)  	 MOLICARE  																							
 ОНЛИТЕСТ (ONLITEST)  	 ONLITEST  																							
 САН СЕНИ (SAN SENI)  	 SAN SENI  																							
 СКИНЛАЙТ (SKINLITE)  	 SKINLITE  																							
 СОФФИСОФ (SOFFISOF)  	 SOFFISOF  																							
 ТОПИКРЕМ (TOPICREM)  	 TOPICREM  																							
 ЮНИ-ГОЛД (UNI-GOLD)  	 UNI-GOLD  																							
 ВИТАТЕКА (VITATEKA)  	 VITATEKA  																							
 МАТЬ-И-МАЧЕХИ ЛИСТЬЯ 	 МАТЬ И МАЧЕХИ ЛИСТЬЯ 																							
 ТУТТИ ФРУТТИ ОМЕГА-3 	 ТУТТИ ФРУТТИ ОМЕГА 3 																							
 ЦИПРОФЛОКСАЦИН-ОПТИК 	 ЦИПРОФЛОКСАЦИН ОПТИК 																							
АЭРОЗОЛЬ ДЛЯ ИНГАЛЯЦИЙ	АЭРОЗ Д/ ИНГ																							
АЭРОЗОЛЬ ДЛЯ ИНГАЛЯЦИЙ	АЭРОЗ Д/ИНГ																							
АЭРОЗОЛЬ ДЛЯ ИНГАЛЯЦИЙ	АЭРОЗ ИНГАЛ																							
БАТОНЧИК ГЛАЗИРОВАННЫЙ	БАТ ГЛАЗИР																							
ВКЛАДЫШИ УРОЛОГИЧЕСКИЕ	 ВКЛАД УРОЛ																							
ГАЗ МЕДИЦИНСКИЙ СЖАТЫЙ	ГАЗ МЕД СЖАТ																							
ГЕЛЬ ДЛЯ ПРИЕМА ВНУТРЬ	ГЕЛЬ Д/ПРИЕМА ВНУТРЬ																							
ГЕЛЬ ИНТРАЦЕРВИКАЛЬНЫЙ	ГЕЛЬ ИНТРАЦЕРВИК																							
ГЕЛЬ СТОМАТОЛОГИЧЕСКИЙ	ГЕЛЬ СТОМАТ																							
ЖИДКОСТЬ ДЛЯ ИНГАЛЯЦИЙ	ЖИДК Д/ИНГ																							
КАРАНДАШ ДЛЯ ИНГАЛЯЦИЙ	КАРАНД Д/ИНГ																							
КАРАНДАШ ДЛЯ ИНГАЛЯЦИЙ	КАРАНД Д/ИНГ-Й																							
КАРАНДАШ ДЛЯ ИНГАЛЯЦИЙ	КАРАНДАШ Д/ИНГ																							
ПЛАСТЫРЬ БАКТЕРИЦИДНЫЙ	ПЛАСТ БАКТ																							
ПОДГУЗНИКИ ДЛЯ ДЕВОЧЕК	ПОДГУЗ Д/ДЕВ																							
ПРЕЗЕРВАТИВЫ ЛАТЕКСНЫЕ	ПРЕЗ ЛАТЕКС																							
СТЕЛЬКИ ОРТОПЕДИЧЕСКИЕ	СТЕЛЬКИ ОРТОПЕД																							
СУСПЕНЗИЯ ДЛЯ ИНЪЕКЦИЙ	СУСП Д/ ИН																							
СУСПЕНЗИЯ ДЛЯ ИНЪЕКЦИЙ	СУСП Д/ИН																							
 ТАБЛЕТКИ ВАГИНАЛЬНЫЕ 	 ТАБ ВАГ 																							
 ТАБЛЕТКИ ЖЕВАТЕЛЬНЫЕ 	 ТАБ ЖЕВ 																							
 ТАБЛЕТКИ НЕЙТРАЛЬНЫЕ 	 ТАБ НЕЙТР 																							
 ТАБЛЕТКИ ПОДЪЯЗЫЧНЫЕ 	 ТАБ ПОДЪЯЗ 																							
 ТАБЛЕТКИ РАСТВОРИМЫЕ 	 ТАБ Р-РИМЫЕ 																							
 БОДИГАРД (BODYGUARD)  	 BODYGUARD  																							
 ДЖОЙДРОПС (JOYDROPS)  	 JOYDROPS  																							
 ВАЛОКОРДИН-ДОКСИЛАМИН 	 ВАЛОКОРДИН ДОКСИЛАМИН 																							
 ГАЛОПЕРИДОЛ-РАТИОФАРМ 	 ГАЛОПЕРИДОЛ РАТИОФАРМ 																							
 КОФЕИН-БЕНЗОАТ НАТРИЯ 	 КОФЕИН БЕНЗОАТ НАТРИЯ 																							
 НУКС ВОМИКА-ГОМАККОРД 	 НУКС ВОМИКА ГОМАККОРД 																							
АНТИПЕРСПИРАНТ АЭРОЗОЛЬ	АНТИПЕРСПИР АЭРОЗ																							
АНТИПЕРСПИРАНТ КАРАНДАШ	АНТИПЕРСПИР КАРАНД																							
ГЕЛЬ ДЛЯ ЛИЦА ОЧИЩАЮЩИЙ	ГЕЛЬ Д/ЛИЦА ОЧИЩ																							
ГРАНУЛЫ ГОМЕОПАТИЧЕСКИЕ	ГОМЕОПАТ.ГРАНУЛЫ																							
ГРАНУЛЫ ГОМЕОПАТИЧЕСКИЕ	ГРАН ГОМЕОПАТ																							
КАПЛИ ДЛЯ ПРИЕМА ВНУТРЬ	КАП Д/ ПРИЕМА ВНУТРЬ																							
КАПЛИ ДЛЯ ПРИЕМА ВНУТРЬ	КАП Д/П/В																							
КАПЛИ ДЛЯ ПРИЕМА ВНУТРЬ	КАП Д/ПРИЕМА ВНУТРЬ																							
КОЛГОТКИ КОМПРЕССИОННЫЕ	КОЛГОТ КОМПРЕС																							
КОНЦЕНТРАТ РАСТИТЕЛЬНЫЙ	КОНЦ РАСТИТ																							
КОНЦЕНТРАТ РАСТИТЕЛЬНЫЙ	КОНЦ-Т РАСТИТ																							
ЛАК-УКРЕПИТЕЛЬ Д/НОГТЕЙ	ЛАК-УКРЕП Д/НОГТ																							
ЛИНЗЫ КОНТАКТНЫЕ МЯГКИЕ	ЛИНЗЫ КОНТАКТ МЯГК																							
ЛИНИМЕНТ С АППЛИКАТОРОМ	ЛИНИМ С АППЛ																							
МАСЛО ДЛЯ ПРИЕМА ВНУТРЬ	МАСЛО Д/ПРИЕМА ВНУТРЬ																							
ПАСТИЛКИ (АПЕЛЬСИНОВЫЕ)	ПАСТ (АПЕЛ)																							
ПАСТА ДЛЯ ПРИЕМА ВНУТРЬ	ПАСТА Д/ПРИЕМА ВНУТРЬ																							
ПЛАСТЫРЬ ОБЕЗБОЛИВАЮЩИЙ	ПЛАСТ ОБЕЗБОЛ																							
ПОВЯЗКА ПРОТИВООЖОГОВАЯ	ПОВЯЗ П/ОЖОГ																							
ПОВЯЗКА ПРОТИВООЖОГОВАЯ	ПОВЯЗКА ПРОТИВООЖОГ																							
ПОДГУЗНИКИ ДЛЯ ВЗРОСЛЫХ	ПОДГУЗ Д/ВЗРОСЛ																							
ПРОКЛАДКИ УРОЛОГИЧЕСКИЕ	ПРОКЛ УРОЛОГ																							
РАСТВОР ГЕМОКОНСЕРВАНТА	Р-Р ГЕМОКОНСЕРВАНТА																							
РАСТВОР ДЛЯ ГЕМОДИАЛИЗА	Р-Р Д/ГЕМОДИАЛИЗА																							
СИСТЕМА ТЕРАПЕВТИЧЕСКАЯ	СИСТ ТЕРАПЕВТ																							
СУППОЗИТОРИИ РЕКТАЛЬНЫЕ	СУПП РЕКТ																							
СУСПЕНЗИЯ ДЛЯ ИНГАЛЯЦИЙ	СУСП Д/ ИНГ																							
СУСПЕНЗИЯ ДЛЯ ИНГАЛЯЦИЙ	СУСП Д/ИНГ																							
ТАБЛЕТКИ ДИСПЕРГИРУЕМЫЕ	ТАБ.ДИСПЕРГ.																							
таблетки сублингвальные	ТАБ.СУБЛИНГВ.																							
 АЛЬГА САН (ALLGA SAN)  	 ALLGA SAN  																							
 АМНИОТЕСТ (AMNIOTEST)  	 AMNIOTEST  																							
 БЭБИ БЛУМ (BABY BLUM)  	 BABY BLUM  																							
 БЭБИ БОРН (BABY BORN)  	 BABY BORN  																							
 КАМАСУТРА (CAMASUTRA)  	 CAMASUTRA  																							
 АЙ ЛАВ Ю (I LOVE YOU)  	 I LOVE YOU  																							
 ДЖУДЖУ  (JUJU) (JUJU)  	 JUJU  																							
 ЛЕДИ ТЕСТ (LADY TEST)  	 LADY TEST  																							
 МАМА ЧЕК (MAMA CHECK)  	 MAMA CHECK  																							
 МАМА ТЕСТ (MAMA TEST)  	 MAMA TEST  																							
 МЕДИСМАРТ (MEDISMART)  	 MEDISMART  																							
 МИКРОЛАЙФ (MICROLIFE)  	 MICROLIFE  																							
 ПРОПЕЛЛЕР (PROPELLER)  	 PROPELLER  																							
 БЕКЛОМЕТАЗОН-АЭРОНАТИВ 	 БЕКЛОМЕТАЗОН АЭРОНАТИВ 																							
 ХЕЛИДОНИУМ-ГОМАККОРД Н 	 ХЕЛИДОНИУМ ГОМАККОРД Н 																							
БАНДАЖ ПОСЛЕОПЕРАЦИОННЫЙ	БАНД ПОСЛЕОПЕРАЦ																							
ГЕЛЬ ГЛАЗНОЙ УВЛАЖНЯЮЩИЙ	ГЕЛЬ ГЛАЗ УВЛАЖ																							
ДЛЯ НАРУЖНОГО ПРИМЕНЕНИЯ	Д/НАР. ПРИМ.																							
ДРАЖЕ КИШЕЧНОРАСТВОРИМЫЕ	ДР КИШЕЧНОРАСТВ																							
КАРАМЕЛЬ ГОМЕОПАТИЧЕСКАЯ	КАРАМ ГОМЕОПАТ																							
КАРАМЕЛЬ ГОМЕОПАТИЧЕСКАЯ	КАРАМЕЛЬ ГОМЕОПАТ-Я																							
КАРАМЕЛЬ ГОМЕОПАТИЧЕСКАЯ	КАРАМЕЛЬ ГОМЕОПАТЕСКАЯ																							
ПЛАСТЫРЬ ТРАНСДЕРМАЛЬНЫЙ	ПЛАСТ Т/Д																							
ПОДГУЗНИКИ ДЛЯ МАЛЬЧИКОВ	ПОДГУЗ Д/МАЛЬЧ																							
ПРИБОР ДЛЯ ЛЕЧЕНИЯ ХРАПА	ПРИБ Д/ЛЕЧ ХРАПА																							
РАЗДЕЛИТЕЛЬ МЕЖПАЛЬЦЕВЫЙ	РАЗД-ЛЬ МЕЖПАЛЬЦ																							
САБО ЖЕНСКИЕ ВСЕСЕЗОННЫЕ	САБО ЖЕН ВСЕСЕЗОН																							
СУППОЗИТОРИИ ВАГИНАЛЬНЫЕ	СУПП ВАГ																							
СУППОЗИТОРИИ ВАГИНАЛЬНЫЕ	СУПП ВАГИН.																							
 АКТИ-ФАЙН (ACTI-FINE)   	 ACTI-FINE  																							
 ХЭЛЛОУ НАУ (HELLO NOW)  	 HELLO NOW  																							
 АЛЬФА-ТОКОФЕРОЛА АЦЕТАТ 	 АЛЬФА ТОКОФЕРОЛА АЦЕТАТ 																							
 ЖЕЛУДОЧНО-КИШЕЧНЫЙ СБОР 	 ЖЕЛУДОЧНО КИШЕЧНЫЙ СБОР 																							
 ЛЮТЕИН-КОМПЛЕКС ДЕТСКИЙ 	 ЛЮТЕИН КОМПЛЕКС ДЕТСКИЙ 																							
БАНДАЖ НА КОЛЕННЫЙ СУСТАВ	БАНД НА КОЛЕН СУСТ																							
ВНУТРИСУСТАВНОГО ВВЕДЕНИЯ	ВНУТРИСУСТАВН.ВВЕД.																							
ГЕЛЬ ДЛЯ ИНТИМНОЙ ГИГИЕНЫ	ГЕЛЬ Д/ИНТИМ ГИГ																							
ГРАНУЛЫ ДЛЯ ПРИЕМА ВНУТРЬ	ГРАН Д/ПРИЕМА ВНУТРЬ																							
ДЕЗОДОРАНТ-АНТИПЕРСПИРАНТ	ДЕЗОДОР -АНТИПЕРСПИР																							
КАПЛИ ГЛАЗНЫЕ И НАЗАЛЬНЫЕ	КАП ГЛАЗ И НАЗ																							
КАПЛИ НАЗАЛЬНЫЕ ДЛЯ ДЕТЕЙ	КАП НАЗ Д/ДЕТ																							
КРЕМ ДЛЯ КОЖИ ВОКРУГ ГЛАЗ	КР Д/КОЖИ ВОКРУГ ГЛАЗ																							
КРЕМ ПРОТИВОАЛЛЕРГИЧЕСКИЙ	КР П/АЛЛЕРГ																							
КРЕМ ПРОТИВОАЛЛЕРГИЧЕСКИЙ	КР ПРОТИВОАЛЛЕРГ																							
КРЕМ ПРОТИВОАЛЛЕРГИЧЕСКИЙ	КРЕМ ПРОТИВОАЛЛЕРГ																							
МАСЛО ЭФИРНОЕ НАТУРАЛЬНОЕ	МАСЛО ЭФИР НАТУР																							
ПАСТИЛКИ ДЛЯ РАССАСЫВАНИЯ	ПАСТ Д/РАС																							
ПОДПЯТОЧНИК САМОКЛЕЯЩИЙСЯ	ПОДПЯТОЧ САМОКЛЕЯЩ																							
ПОРОШОК ДЛЯ ПРИЕМА ВНУТРЬ	ПОР Д/ПРИЕМА ВНУТРЬ																							
РАСТВОР ДЛЯ ПРИЕМА ВНУТРЬ	Р-Р Д/ ПРИЕМА ВНУТРЬ																							
РАСТВОР ДЛЯ ЭЛЕКТРОФОРЕЗА	Р-Р Д/ ЭЛ/ФОРЕЗА																							
РАСТВОР ДЛЯ ПРИЕМА ВНУТРЬ	Р-Р Д/ПРИЕМА ВНУТРЬ																							
РАСТВОР ДЛЯ ЭЛЕКТРОФОРЕЗА	Р-Р Д/ЭЛЕКТРОФОРЕЗА																							
РАСТВОР КОНЦЕНТРИРОВАННЫЙ	Р-Р КОНЦ																							
РЕКЛИНАТОР ОРТОПЕДИЧЕСКИЙ	РЕКЛИНАТОР ОРТОПЕД																							
СПРЕЙ НАЗАЛЬНЫЙ ДЛЯ ДЕТЕЙ	СПР НАЗ Д/ДЕТ																							
 ТАБЛЕТКИ ДИСПЕРГИРУЕМЫЕ 	 ТАБ ДИСПЕРГИР 																							
 ТАБЛЕТКИ СУБЛИНГВАЛЬНЫЕ 	 ТАБ СУБЛИНГВ 																							
ТАБЛЕТКИ ДЛЯ РАССАСЫВАНИЯ	ТБЛ Д/РАССАСЫВ.																							
ТРАВА РЕЗАНО-ПРЕССОВАННАЯ	ТР РЕЗ -ПРЕС																							
ЭЛИКСИР ДЛЯ ПРИЕМА ВНУТРЬ	ЭЛИКС Д/ПРИЕМА ВНУТРЬ																							
 БЭБИ-ФРАНК (BABY-FRANK)  	 BABY-FRANK  																							
 БЕТАДИАЛИС (BETADIALIS)  	 BETADIALIS  																							
 СУПЕР СЕНИ  (SUPER SENI) 	 SUPER SENI  																							
 НАШАТЫРНО-АНИСОВЫЕ КАПЛИ 	 НАШАТЫРНО АНИСОВЫЕ КАПЛИ 																							
 РИБОФЛАВИН-МОНОНУКЛЕОТИД 	 РИБОФЛАВИН МОНОНУКЛЕОТИД 																							
ГРАНУЛЫ КИШЕЧНОРАСТВОРИМЫЕ	ГРАН КИШЕЧНОРАСТВ																							
ЗУБНАЯ ЩЕТКА ЭЛЕКТРИЧЕСКАЯ	ЗУБН ЩЕТКА ЭЛЕКТР																							
КАПСУЛЫ КИШЕЧНОРАСТВОРИМЫЕ	КАПС КИШЕЧНОРАСТВ																							
КРЕМ С ТОНИРУЮЩИМ ЭФФЕКТОМ	КР С ТОНИР ЭФФ																							
КРЕМ С ТОНИРУЮЩИМ ЭФФЕКТОМ	КРЕМ С ТОНИР ЭФФ																							
КРЕМ С ТОНИРУЮЩИМ ЭФФЕКТОМ	КРЕМ С ТОНИР ЭФФЕКТОМ																							
ЛИОФИЛИЗАТ Д/ПРИГ РАСТВОРА	ЛИОФИЛ Д/ ПРИГ Р-РА																							
ОПОДЕЛЬДОК ГОМЕОПАТИЧЕСКИЙ	ОПОДЕЛЬДОК ГОМЕОПАТ																							
РАСТВОР ДЛЯ ГЕМОФИЛЬТРАЦИИ	Р-Р Д/ ГЕМОФИЛЬТРАЦИ																							
РАСТВОР ДЛЯ ГЕМОФИЛЬТРАЦИИ	Р-Р Д/ГЕМОФИЛЬТР																							
РАСТВОР ОФТАЛЬМОЛОГИЧЕСКИЙ	Р-Р ОФТАЛЬМ.																							
СЫРЬЕ РАСТИТЕЛЬНОЕ ЦЕЛЬНОЕ	СЫРЬЕ РАСТИТ ЦЕЛЬН																							
 ТАБЛЕТКИ ГОМЕОПАТИЧЕСКИЕ 	 ТАБ ГОМЕОПАТ 																							
 ТАБЛЕТКИ ДЛЯ ИМПЛАНТАЦИИ 	 ТАБ Д/ИМПЛАНТ 																							
 ТАБЛЕТКИ ДЛЯ ИМПЛАНТАЦИИ 	 ТАБ Д/ИМПЛАНТАЦИИ 																							
 ТАБЛЕТКИ ШИПУЧИЕ ДЕТСКИЕ 	 ТАБ ШИП ДЕТ 																							
ЭМУЛЬСИЯ ДЛЯ ПРИЕМА ВНУТРЬ	ЭМУЛЬС Д/ПРИЕМА ВНУТРЬ																							
 ЛИТТЛ БЭБИ (LITTLE BABY)  	 LITTLE BABY  																							
 НЬЮТРОДЖИНА (NEUTROGENA)  	 NEUTROGENA  																							
 СПЛЭШГЛАЙД (SPLASHGLIDE)  	 SPLASHGLIDE  																							
 БАРБАРИС КОМП (ИОВ-МАЛЫШ) 	 БАРБАРИС КОМП (ИОВ МАЛЫШ) 																							
 НОРВЕГИАН ФИШ ОИЛ ОМЕГА-3 	 НОРВЕГИАН ФИШ ОИЛ ОМЕГА 3 																							
 САЛИЦИЛОВО-ЦИНКОВАЯ ПАСТА 	 САЛИЦИЛОВО ЦИНКОВАЯ ПАСТА 																							
для приготовления суспензии	Д/ПРИГ.СУСП.																							
КРЕМ ПРОТИВОГЕМОРРОИДАЛЬНЫЙ	КР П/ГЕМОР																							
КРЕМ ПРОТИВОГЕМОРРОИДАЛЬНЫЙ	КР ПРОТИВОГЕМОР																							
КРЕМ ПРОТИВОГЕМОРРОИДАЛЬНЫЙ	КРЕМ ПРОТИВОГЕМОР																							
ПЛАСТИНЫ ПОКРЫТЫЕ ОБОЛОЧКОЙ	ПЛАСТ П/О																							
РАСТВОР ДЛЯ КОНТАКТНЫХ ЛИНЗ	Р-Р Д/КОНТ ЛИНЗ																							
РАСТВОР ДЛЯ КОНТАКТНЫХ ЛИНЗ	Р-Р Д/КОНТАКТНЫХ ЛИНЗ																							
САЛФЕТКИ Д/ИНТИМНОЙ ГИГИЕНЫ	САЛФ Д/ИНТИМ ГИГ																							
СБОР РАСТИТЕЛЬНЫЙ - ПОРОШОК	СБОР РАСТИТ - ПОР																							
СУСПЕНЗИЯ ДЛЯ ПРИЕМА ВНУТРЬ	СУСП Д/ ПРИЕМА ВНУТРЬ																							
СУСПЕНЗИЯ ДЛЯ ПРИЕМА ВНУТРЬ	СУСП Д/ПРИЕМА ВНУТРЬ																							
 ТАБЛЕТКИ ДЛЯ РАССАСЫВАНИЯ 	 ТАБ Д/РАС 																							
 ТАБЛЕТКИ ДЛЯ РАССАСЫВАНИЯ 	 ТАБ Д/РАССАС 																							
 таблетки для рассасывания 	 ТАБ. Д/РАССАСЫВ. 																							
 таблетки для рассасывания 	 ТАБ. Д/РАССАСЫВ. 																							
ТАБЛЕТКИ ПОКРЫТЫЕ ОБОЛОЧКОЙ	ТАБ.П/О																							
таблетки покрытые оболочкой	ТБ.П/О																							
ТАБЛЕТКИ ПОКРЫТЫЕ ОБОЛОЧКОЙ	тбл п.о.																							
ТАБЛЕТКИ ПОКРЫТЫЕ ОБОЛОЧКОЙ	ТБЛ П/О																							
ЧУЛКИ КОМПРЕССИОННЫЕ 1КЛАСС	ЧУЛКИ КОМПРЕС 1КЛАСС																							
ЧУЛКИ КОМПРЕССИОННЫЕ 2КЛАСС	ЧУЛКИ КОМПРЕС 2КЛАСС																							
 БЭБИ КИНДЕР (BABY KINDER)  	 BABY KINDER  																							
 ЦЕТТУА  (CETTUA) (CETTUA)  	 CETTUA  																							
 ФУТ ЭКСПЕРТ (FOOT EXPERT)  	 FOOT EXPERT  																							
 КОДОМО БЭБИ (KODOMO BABY)  	 KODOMO BABY  																							
 ГЛЮКОЗАМИН-ХОНДРОИТИН ПЛЮС 	 ГЛЮКОЗАМИН ХОНДРОИТИН ПЛЮС 																							
ГЕЛЬ ДЛЯ МЕСТНОГО ПРИМЕНЕНИЯ	ГЕЛЬ Д/МЕСТН ПРИМ																							
ГОЛЬФЫ КОМПРЕССИОННЫЕ 1КЛАСС	ГОЛЬФЫ КОМПРЕС 1КЛАСС																							
ГОЛЬФЫ КОМПРЕССИОННЫЕ 2КЛАСС	ГОЛЬФЫ КОМПРЕС 2КЛАСС																							
МАЗЬ ДЛЯ МЕСТНОГО ПРИМЕНЕНИЯ	МАЗЬ Д/МЕСТН ПРИМ																							
ПЕНА РЕКТАЛЬНАЯ ДОЗИРОВАННАЯ	ПЕНА РЕКТ ДОЗ																							
РАСТВОР ДЛЯ УХОДА ЗА ЛИНЗАМИ	Р-Р Д/ УХОДА ЗА ЛИНЗАМИ																							
РАСТВОР ДЛЯ УХОДА ЗА ЛИНЗАМИ	Р-Р Д/УХОДА ЗА ЛИНЗ																							
САЛФЕТКИ МАРЛЕВЫЕ СТЕРИЛЬНЫЕ	САЛФ МАРЛ СТЕР																							
СПРЕЙ ДЛЯ ГОРЛА ДОЗИРОВАННЫЙ	СПР Д/ ГОРЛА ДОЗ																							
СПРЕЙ НАЗАЛЬНЫЙ ДОЗИРОВАННЫЙ	СПР НАЗ ДОЗ																							
СЫРЬЕ РАСТИТЕЛЬНОЕ - ПОРОШОК	СЫРЬЕ РАСТИТ - ПОР																							
 ТАБЛЕТКИ ЛИОФИЛИЗИРОВАННЫЕ 	 ТАБ ЛИОФИЛ 																							
 ТАБЛЕТКИ ШИПУЧИЕ ДЛЯ ДЕТЕЙ 	 ТАБ ШИП Д/ДЕТ 																							
 ДЖЕНИУС БЭБИ (GENIUS BABY)  	 GENIUS BABY  																							
 ХЭЛИНГ ДЕРМ (HEALING DERM)  	 HEALING DERM  																							
 АЙ ШУЭР  (I SURE) (I SURE)  	 I SURE  																							
 МЕД РЕСПОНС (MED RESPONSE)  	 MED RESPONSE  																							
 ИНДОМЕТАЦИН 100 БЕРЛИН-ХЕМИ 	 ИНДОМЕТАЦИН 100 БЕРЛИН ХЕМИ 																							
ВОДА МИНЕРАЛЬНАЯ ГАЗИРОВАННАЯ	ВОДА МИН ГАЗ																							
ВОДА МИНЕРАЛЬНАЯ ГАЗИРОВАННАЯ	ВОДА МИНЕР ГАЗИР																							
ГЕЛЬ ДЛЯ НАРУЖНОГО ПРИМЕНЕНИЯ	ГЕЛЬ Д/НАРУЖ ПРИМ																							
ГРАНУЛЫ ДЛЯ ПРИГОТОВЛЕНИЯ ЧАЯ	ГРАН Д/ ПРИГ ЧАЯ																							
ГРАНУЛЫ ДЛЯ ПРИГОТОВЛЕНИЯ ЧАЯ	ГРАН Д/ПРИГ ЧАЯ																							
КАПЛИ ГЛАЗНЫЕ ГОМЕОПАТИЧЕСКИЕ	КАП ГЛАЗ ГОМЕОПАТ																							
КАПЛИ ГЛАЗНЫЕ УШНЫЕ НАЗАЛЬНЫЕ	КАП ГЛАЗ УШ НАЗ																							
КЛЕЙ ДЛЯ НАРУЖНОГО ПРИМЕНЕНИЯ	КЛЕЙ Д/НАРУЖ ПРИМ																							
КРЕМ ДЛЯ НАРУЖНОГО ПРИМЕНЕНИЯ	КР Д/НАРУЖ ПРИМ																							
КРЕМ ДЛЯ НАРУЖНОГО ПРИМЕНЕНИЯ	КРЕМ Д/НАРУЖ ПРИМ																							
МАЗЬ ДЛЯ НАРУЖНОГО ПРИМЕНЕНИЯ	МАЗЬ Д/НАРУЖ ПРИМ																							
ПАСТА ДЛЯ МЕСТНОГО ПРИМЕНЕНИЯ	ПАСТА Д/МЕСТН ПРИМ																							
РАСТВОР ДЛЯ ИНЪЕКЦИЙ МАСЛЯНЫЙ	Р-Р Д/ИН МАСЛ																							
РАСТВОР ДЛЯ ИНЪЕКЦИЙ В ШПРИЦЕ	Р-Р Д/ИН ШПР																							
РАСТВОР МАСЛЯНЫЙ ДЛЯ ИНЪЕКЦИЙ	Р-Р МАСЛ.Д/ИН																							
РАСТВОР-КАПЛИ ГЛАЗНЫЕ И УШНЫЕ	Р-Р-КАП ГЛАЗ/УШ																							
СПРЕЙ ДЛЯ МЕСТНОГО ПРИМЕНЕНИЯ	СПР Д/ МЕСТН ПРИМ																							
СПРЕЙ ДЛЯ МЕСТНОГО ПРИМЕНЕНИЯ	СПР Д/МЕСТН ПРИМ																							
 ТАБЛЕТКИ КИШЕЧНОРАСТВОРИМЫЕ 	 ТАБ КИШЕЧНОР-РИМЫЕ 																							
 ТАБЛЕТКИ ПОКРЫТЫЕ ОБОЛОЧКОЙ 	 ТАБ П/О 																							
 МАМА КОМФОРТ (MAMA COMFORT)  	 MAMA COMFORT  																							
БАНДАЖ НА ГОЛЕНОСТОПНЫЙ СУСТАВ	БАНД НА Г/С СУСТ																							
БАНДАЖ НА ГОЛЕНОСТОПНЫЙ СУСТАВ	БАНД НА ГОЛЕНОСТОП СУСТ																							
БАНДАЖ НА ЛУЧЕЗАПЯСТНЫЙ СУСТАВ	БАНД НА Л/З СУСТ																							
БАНДАЖ НА ЛУЧЕЗАПЯСТНЫЙ СУСТАВ	БАНД НА ЛУЧЕЗАПЯСТ СУСТ																							
БАНДАЖ НА ТАЗОБЕДРЕННЫЙ СУСТАВ	БАНД НА Т/Б СУСТ																							
БАНДАЖ НА ТАЗОБЕДРЕННЫЙ СУСТАВ	БАНД НА ТАЗОБЕДРЕН СУСТ																							
ВАТНЫЕ ПАЛОЧКИ С ОГРАНИЧИТЕЛЕМ	ВАТ ПАЛОЧ С ОГРАНИЧИТ																							
МАСЛО ДЛЯ РЕКТАЛЬНОГО ВВЕДЕНИЯ	МАСЛО Д/РЕКТ ВВЕД																							
МАСЛО ДЛЯ РЕКТАЛЬНОГО ВВЕДЕНИЯ	МАСЛО Д/РЕКТ ВВЕД-Я																							
ОПОЛАСКИВАТЕЛЬ ДЛЯ ПОЛОСТИ РТА	ОПОЛАСК Д/ПОЛОСТИ РТА																							
ПАСТА ДЛЯ НАРУЖНОГО ПРИМЕНЕНИЯ	ПАСТА Д/НАРУЖ ПРИМ																							
ПОВЯЗКА С ЛИПКИМИ КРАЯМИ 10Х14	ПОВЯЗ С ЛИПК КРАЯМИ 10Х14																							
ПОЛОСКАНИЕ ДЛЯ РОТОВОЙ ПОЛОСТИ	ПОЛОСК Д/РОТ ПОЛОСТИ																							
ПРЕЗЕРВАТИВЫ АРОМАТИЗИРОВАННЫЕ	ПРЕЗ АРОМАТ																							
РАСТВОР ДЛЯ ИНЪЕКЦИЙ АМПУЛЬНЫЙ	Р-Р Д/ИН АМП																							
СПРЕЙ ДЛЯ НАРУЖНОГО ПРИМЕНЕНИЯ	СПР Д/ НАРУЖ ПРИМ																							
СПРЕЙ ДЛЯ НАРУЖНОГО ПРИМЕНЕНИЯ	СПР Д/НАРУЖ ПРИМ																							
СПРЕЙ ПОДЪЯЗЫЧНЫЙ ДОЗИРОВАННЫЙ	СПР ПОДЪЯЗ ДОЗ																							
СТЕЛЬКИ ОРТОПЕДИЧЕСКИЕ ДЕТСКИЕ	СТЕЛЬКИ ОРТОПЕД ДЕТ																							
 ХАРМОНИ  (HARMONY) (HARMONY)  	 HARMONY  																							
 ЛЯ РОШ-ПОЗЭ (LA ROCHE-POSAY)  	 LA ROCHE-POSAY  																							
 ПЛЭЖЭ  (PLEASURE) (PLEASURE)  	 PLEASURE  																							
 КАЛЬЦИЙ-МАГНИЙ С ВИТАМИНОМ D3 	 КАЛЬЦИЙ МАГНИЙ С ВИТАМИНОМ D3 																							
 ЛАНДЫШЕВО-ПУСТЫРНИКОВЫЕ КАПЛИ 	 ЛАНДЫШЕВО ПУСТЫРНИКОВЫЕ КАПЛИ 																							
АЭРОЗОЛЬ НАЗАЛЬНЫЙ ДОЗИРОВАННЫЙ	АЭРОЗ НАЗ ДОЗ																							
ГЕЛЬ ВАГИНАЛЬНЫЙ С АППЛИКАТОРОМ	ГЕЛЬ ВАГ С АППЛ																							
КРЕМ ВАГИНАЛЬНЫЙ С АППЛИКАТОРОМ	КР ВАГ С АППЛ																							
ПЛЕНКИ ДЛЯ НАКЛЕИВАНИЯ НА ДЕСНУ	ПЛ Д/НАКЛ НА ДЕСНУ																							
ПЛЕНКИ ДЛЯ НАКЛЕИВАНИЯ НА ДЕСНУ	ПЛ Д/НАКЛЕИВ НА ДЕСНУ																							
ПЛЕНКИ ДЛЯ НАКЛЕИВАНИЯ НА ДЕСНУ	ПЛ Д/НАКЛЕИВАНИЯ НА ДЕСНУ																							
ПЛЕНКИ ДЛЯ НАКЛЕИВАНИЯ НА ДЕСНУ	ПЛЕНКИ Д/ НАКЛЕИВАНИЯ НА ДЕСНУ																							
ПОРОШОК ДЛЯ МЕСТНОГО ПРИМЕНЕНИЯ	ПОР Д/МЕСТН ПРИМ																							
РАСТВОР ДЛЯ МЕСТНОГО ПРИМЕНЕНИЯ	Р-Р Д/ МЕСТН ПРИМ																							
РАСТВОР ДЛЯ ПОДКОЖНОГО ВВЕДЕНИЯ	Р-Р Д/ П/К ВВЕД																							
РАСТВОР ДЛЯ ПОДКОЖНОГО ВВЕДЕНИЯ	Р-Р Д/ИН П/К																							
РАСТВОР ДЛЯ МЕСТНОГО ПРИМЕНЕНИЯ	Р-Р Д/МЕСТН ПРИМ																							
РАСТВОР ДЛЯ ПОДКОЖНОГО ВВЕДЕНИЯ	Р-Р Д/П/К ВВЕД																							
САНДАЛИИ ДЕТСКИЕ ОРТОПЕДИЧЕСКИЕ	САНДАЛИИ ДЕТ ОРТОПЕД																							
СЫРЬЕ РАСТИТЕЛЬНОЕ ИЗМЕЛЬЧЕННОЕ	СЫРЬЕ РАСТИТ ИЗМЕЛЬЧ																							
 ПЕРВЫЙ ОТВЕТ (FIRST RESPONSE)  	 FIRST RESPONSE  																							
 ДЖОНСОНС БЭБИ (JOHNSONS BABY)  	 JOHNSONS BABY  																							
 СОМАТОН-ЛЮКС КАРАВАЕВА БАЛЬЗАМ 	 СОМАТОН ЛЮКС КАРАВАЕВА БАЛЬЗАМ 																							
 СОМАТОН-РИТМ КАРАВАЕВА БАЛЬЗАМ 	 СОМАТОН РИТМ КАРАВАЕВА БАЛЬЗАМ 																							
АРОМАКУЛОН ИЗ НАТУРАЛЬНОГО КАМНЯ	АРОМАКУЛ ИЗ НАТУР КАМНЯ																							
АЭРОЗОЛЬ ДЛЯ МЕСТНОГО ПРИМЕНЕНИЯ	АЭРОЗ Д/ МЕСТН ПРИМ																							
АЭРОЗОЛЬ ДЛЯ МЕСТНОГО ПРИМЕНЕНИЯ	АЭРОЗ Д/МЕСТН ПРИМ																							
КАПСУЛЫ С ПОРОШКОМ ДЛЯ ИНГАЛЯЦИЙ	КАПС С ПОР Д/ИНГ																							
КАПСУЛЫ С ПОРОШКОМ ДЛЯ ИНГАЛЯЦИЙ	КАПСУЛЫ С ПОРОШКОМ Д/ ИНГ																							
ПОРОШОК ДЛЯ ИНГАЛЯЦИЙ В КАПСУЛАХ	ПОР Д/ИНГ В КАПС																							
ПОРОШОК ДЛЯ НАРУЖНОГО ПРИМЕНЕНИЯ	ПОР Д/НАРУЖ ПРИМ																							
РАСТВОР ДЛЯ ИНЪЕКЦИЙ И ИНГАЛЯЦИЙ	Р-Р Д/ ИН И ИНГ																							
РАСТВОР ДЛЯ НАРУЖНОГО ПРИМЕНЕНИЯ	Р-Р Д/ НАРУЖ ПРИМ																							
РАСТВОР ДЛЯ РЕКТАЛЬНОГО ВВЕДЕНИЯ	Р-Р Д/ РЕКТ ВВЕД																							
РАСТВОР ДЛЯ ИНЪЕКЦИЙ И ИНГАЛЯЦИЙ	Р-Р Д/ИН И ИНГ																							
РАСТВОР ДЛЯ ИНФУЗИЙ ЗАМОРОЖЕННЫЙ	Р-Р Д/ИНФ ЗАМОРОЖЕННЫЙ																							
РАСТВОР ДЛЯ НАРУЖНОГО ПРИМЕНЕНИЯ	Р-Р Д/НАРУЖ ПРИМ																							
РАСТВОР ДЛЯ РЕКТАЛЬНОГО ВВЕДЕНИЯ	Р-Р Д/РЕКТ ВВЕД																							
СУСПЕНЗИЯ ДЛЯ ИНЪЕКЦИЙ ДЛЯ ДЕТЕЙ	СУСП Д/ИН Д/ДЕТ																							
 КЕАТЕСТ  (CARETEST) (CARETEST)  	 CARETEST  																							
 КОНЦЕНТРАТ РЫБЬЕГО ЖИРА ОМЕГА-3 	 КОНЦЕНТРАТ РЫБЬЕГО ЖИРА ОМЕГА 3 																							
АЭРОЗОЛЬ ДЛЯ НАРУЖНОГО ПРИМЕНЕНИЯ	АЭРОЗ Д/ НАРУЖ ПРИМ																							
АЭРОЗОЛЬ ДЛЯ НАРУЖНОГО ПРИМЕНЕНИЯ	АЭРОЗ Д/НАРУЖ ПРИМ																							
АЭРОЗОЛЬ ДЛЯ НАРУЖНОГО ПРИМЕНЕНИЯ	АЭРОЗ НАРУЖ																							
АЭРОЗОЛЬ ПОДЪЯЗЫЧНЫЙ ДОЗИРОВАННЫЙ	АЭРОЗ ПОДЪЯЗ ДОЗ																							
БЮСТГАЛТЕР Д/ФИКСАЦИИ ЭКЗОПРОТЕЗА	БЮСТ Д/ФИКС ЭКЗОПРОТЕЗА																							
ДЕЗОДОРАНТ-АНТИПЕРСПИРАНТ ГЕЛЕВЫЙ	ДЕЗОДОР -АНТИПЕРСПИР ГЕЛЕВ																							
ДЕЗОДОРАНТ-АНТИПЕРСПИРАНТ ТВЕРДЫЙ	ДЕЗОДОР -АНТИПЕРСПИР ТВЕРД																							
ЖИДКОСТЬ ДЛЯ НАРУЖНОГО ПРИМЕНЕНИЯ	ЖИДК Д/НАРУЖ ПРИМ																							
КАПЛИ ГЛАЗНЫЕ ДЛЯ КОНТАКТНЫХ ЛИНЗ	КАП ГЛАЗ Д/КОНТАКТ ЛИНЗ																							
КАПЛИ ДЛЯ ПРИЕМА ВНУТРЬ ДЛЯ ДЕТЕЙ	КАП Д/ПРИЕМА ВНУТРЬ Д/ДЕТ																							
КАПЛИ ДЛЯ ПРИЕМА ВНУТРЬ СПИРТОВЫЕ	КАП Д/ПРИЕМА ВНУТРЬ СПИРТ																							
КРЕМ-УХОД ДЛЯ ОБЛАСТИ ВОКРУГ ГЛАЗ	КР -УХОД Д/ОБЛ ВОКРУГ ГЛАЗ																							
ЛИНИМЕНТ ДЛЯ НАРУЖНОГО ПРИМЕНЕНИЯ	ЛИНИМ Д/НАРУЖ ПРИМ																							
СУППОЗИТОРИИ РЕКТАЛЬНЫЕ ДЛЯ ДЕТЕЙ	СУПП РЕКТ Д/ДЕТ																							
СУСПЕНЗИЯ ДЛЯ ПОДКОЖНОГО ВВЕДЕНИЯ	СУСП Д/ П/К ВВЕД																							
СУСПЕНЗИЯ ДЛЯ ПОДКОЖНОГО ВВЕДЕНИЯ	СУСП Д/П/К ВВЕД																							
ЖИДКИЙ ЭКСТРАКТ ДЛЯ ПРИЕМА ВНУТРЬ	ЭКСТР ЖИД Д/ПРИЕМА ВНУТРЬ																							
 ТРОЙНАЯ ОМЕГА-3 950 МГ ЭПК И ДГК 	 ТРОЙНАЯ ОМЕГА 3 950 МГ ЭПК И ДГК 																							
АНТИПЕРСПИРАНТ ИНТИМНЫЙ ДЛЯ ЖЕНЩИН	АНТИПЕРСПИР ИНТИМ Д/ЖЕН																							
ГРАНУЛЫ ПРОЛОНГИРОВАННОГО ДЕЙСТВИЯ	ГРАН ПРОЛОНГ ДЕЙСТВ																							
ДЕЗОДОРАНТ-АНТИПЕРСПИРАНТ АЭРОЗОЛЬ	ДЕЗОДОР -АНТИПЕРСПИР АЭРОЗ																							
КАПЛИ ГЛАЗНЫЕ ДЛЯ ЛИНЗ УВЛАЖНЯЮЩИЕ	КАП ГЛАЗ Д/ЛИНЗ УВЛ-Е																							
КАПСУЛЫ ВАГИНАЛЬНЫЕ С АППЛИКАТОРОМ	КАПС ВАГ С АППЛ																							
КАПСУЛЫ ВАГИНАЛЬНЫЕ С АППЛИКАТОРОМ	КАПС ВАГИНАЛЬНЫЕ С АППЛ																							
КАПСУЛЫ ПРОЛОНГИРОВАННОГО ДЕЙСТВИЯ	КАПС ПРОЛОН-ГО ДЕЙСТВ																							
КАПСУЛЫ ПРОЛОНГИРОВАННОГО ДЕЙСТВИЯ	КАПС ПРОЛОНГ ДЕЙСТВ																							
КАПСУЛЫ ПРОЛОНГИРОВАННОГО ДЕЙСТВИЯ	КАПС ПРОЛОНГ-ГО ДЕЙ-Я																							
КАПСУЛЫ ПРОЛОНГИРОВАННОГО ДЕЙСТВИЯ	КАПСУЛЫ ПРОЛОНГ ДЕЙСТВ																							
ОЧКИ ПОЛЯРИЗАЦИОННЫЕ ДЛЯ ВОДИТЕЛЕЙ	ОЧКИ ПОЛЯРИЗАЦ Д/ВОДИТ																							
ПОРОШОК ДЛЯ ПРИГОТОВЛЕНИЯ РАСТВОРА	ПОР Д/ ПРИГ Р-РА																							
ПОРОШОК ДЛЯ ИНГАЛЯЦИЙ ДОЗИРОВАННЫЙ	ПОР Д/ИНГ ДОЗ																							
ПОРОШОК ДЛЯ ИНГАЛЯЦИЙ ДОЗИРОВАННЫЙ	ПОР Д/ИНГ ДОЗОВАН																							
ПОРОШОК ДЛЯ ПРИГОТОВЛЕНИЯ КОКТЕЙЛЯ	ПОР Д/ПРИГ КОКТЕЙЛЯ																							
ПОРОШОК ДЛЯ ПРИГОТОВЛЕНИЯ РАСТВОРА	ПОР Д/ПРИГ Р-РА																							
РАСТВОР ДЛЯ ВНУТРИВЕННОГО ВВЕДЕНИЯ	Р-Р Д/ В/В ВВЕД																							
РАСТВОР ДЛЯ ВНУТРИКОЖНОГО ВВЕДЕНИЯ	Р-Р Д/ ВНУТРИКОЖ ВВЕД																							
РАСТВОР ДЛЯ ИНГАЛЯЦИЙ ДОЗИРОВАННЫЙ	Р-Р Д/ ИНГ ДОЗ																							
РАСТВОР ДЛЯ ПОЛОСКАНИЯ ПОЛОСТИ РТА	Р-Р Д/ ПОЛОСКАНИЯ ПОЛОСТИ РТА																							
РАСТВОР ДЛЯ ВНУТРИВЕННОГО ВВЕДЕНИЯ	Р-Р Д/В/В ВВЕД																							
РАСТВОР ДЛЯ ВНУТРИКОЖНОГО ВВЕДЕНИЯ	Р-Р Д/ВНУТРИКОЖ ВВЕД																							
РАСТВОР ДЛЯ ИНГАЛЯЦИЙ ДОЗИРОВАННЫЙ	Р-Р Д/ИНГ ДОЗ																							
РАСТВОР ДЛЯ ПОЛОСКАНИЯ ПОЛОСТИ РТА	Р-Р Д/ПОЛОСК ПОЛОСТИ РТА																							
РАСТВОР ДЛЯ ПОЛОСКАНИЯ ПОЛОСТИ РТА	Р-Р Д/ПОЛОСКАНИЯ ПОЛОСТИ РТА																							
РАСТВОР ДЛЯ ПРИЕМА ВНУТРЬ МАСЛЯНЫЙ	Р-Р Д/ПРИЕМА ВНУТРЬ МАСЛ																							
РАСТВОР МАСЛЯНЫЙ ДЛЯ ПРИЕМА ВНУТРЬ	Р-Р МАСЛ Д/ПРИЕМА ВНУТРЬ																							
СУСПЕНЗИЯ ДЛЯ НАРУЖНОГО ПРИМЕНЕНИЯ	СУСП Д/НАРУЖ ПРИМ																							
 ТАБЛЕТКИ ПОКРЫТЫЕ ОБОЛОЧКОЙ МИТЕ 	 ТАБ П/О МИТЕ 																							
 ФЛЕКСИТОЛ  (FLEXITOL) (FLEXITOL)  	 FLEXITOL  																							
 Л/П МАДИТОЛ  (MADITOL) (MADITOL)  	 MADITOL  																							
 ДВОЙНАЯ ОМЕГА -3 700 МГ ЭПК И ДГК 	 ДВОЙНАЯ ОМЕГА 3 700 МГ ЭПК И ДГК 																							
 СИРОП ПОДОРОЖНИКА И МАТЬ-И-МАЧЕХИ 	 СИРОП ПОДОРОЖНИКА И МАТЬ И МАЧЕХИ 																							
АЭРОЗОЛЬ ДЛЯ ИНГАЛЯЦИЙ ДОЗИРОВАННЫЙ	АЭР. Д/ИНГ. ДОЗИР.																							
АЭРОЗОЛЬ ДЛЯ ИНГАЛЯЦИЙ ДОЗИРОВАННЫЙ	АЭРОЗ Д/ ИНГ ДОЗ																							
АЭРОЗОЛЬ ДЛЯ ИНГАЛЯЦИЙ ДОЗИРОВАННЫЙ	АЭРОЗ Д/ИНГ ДОЗ																							
АЭРОЗОЛЬ ДЛЯ ИНГАЛЯЦИЙ ДОЗИРОВАННЫЙ	АЭРОЗ ИНГАЛ ДОЗ																							
БАНДАЖ НА ШЕЙНЫЙ ОТДЕЛ ПОЗВОНОЧНИКА	БАНД НА ШЕЙН ОТДЕЛ ПОЗВОНОЧ																							
БАНДАЖ ПОСЛЕОПЕРАЦИОННЫЙ ЭЛАСТИЧНЫЙ	БАНД ПОСЛЕОПЕРАЦ ЭЛАСТ																							
ГРАНУЛЫ ГОМЕОПАТИЧЕСКИЕ В КОМПЛЕКТЕ	ГРАН ГОМЕОПАТ В КОМПЛЕКТЕ																							
КАПСУЛЫ ДЛЯ ИНГАЛЯЦИЙ С ИНГАЛЯТОРОМ	КАПС Д/ИНГ С ИНГАЛЯТ																							
ЛИОФИЛИЗАТ ДЛЯ ПРИГОТОВЛЕНИЯ КАПЕЛЬ	ЛИОФ-Т Д/ ПРИГ КАПЕЛЬ																							
ЛИОФИЛИЗАТ ДЛЯ ПРИГОТОВЛЕНИЯ КАПЕЛЬ	ЛИОФ-Т Д/ПРИГ КАПЕЛЬ																							
ЛИОФИЛИЗАТ ДЛЯ ПРИГОТОВЛЕНИЯ КАПЕЛЬ	ЛИОФ-Т Д/ПРИГ-Я КАП																							
ЛИОФИЛИЗАТ ДЛЯ ПРИГОТОВЛЕНИЯ КАПЕЛЬ	ЛИОФ-Т Д/ПРИГ-Я КАПЕЛЬ																							
ЛИОФИЛИЗАТ ДЛЯ ПРИГОТОВЛЕНИЯ КАПЕЛЬ	ЛИОФИЛ Д/ ПРИГ КАПЕЛЬ																							
ПЛЕНКИ ДИСПЕРГИРУЕМЫЕ В ПОЛОСТИ РТА	ПЛ ДИСПЕРГ В ПОЛОСТИ РТА																							
ПЛЕНКИ ДИСПЕРГИРУЕМЫЕ В ПОЛОСТИ РТА	ПЛ ДИСПЕРГ-ЫЕ В ПОЛОСТИ РТА																							
ПЛЕНКИ ДИСПЕРГИРУЕМЫЕ В ПОЛОСТИ РТА	ПЛЕНКИ ДИСПЕРГИР В ПОЛОСТИ РТА																							
ПОРОШОК И РЕЗАНО-ПРЕССОВАННАЯ ТРАВА	ПОР И РЕЗ -ПРЕС ТР																							
ПОРОШОК ДЛЯ ВНУТРИМЫШЕЧНЫХ ИНЪЕКЦИЙ	ПОРОШОК Д/ИНЪ В/М																							
РАСТВОР ДЛЯ ВНУТРИГЛАЗНОГО ВВЕДЕНИЯ	Р-Р Д/ ВНУТРИГЛАЗ ВВЕД																							
РАСТВОР ДЛЯ ПЕРИТОНЕАЛЬНОГО ДИАЛИЗА	Р-Р Д/ ПЕРИТОНЕАЛЬНОГО ДИАЛИЗА																							
РАСТВОР ДЛЯ ВНУТРИМЫШЕЧНЫХ ИНЪЕКЦИЙ	Р-Р Д/В/М ИН																							
РАСТВОР ДЛЯ ВНУТРИГЛАЗНОГО ВВЕДЕНИЯ	Р-Р Д/ВНУТРИГЛАЗ ВВЕД																							
РАСТВОР ДЛЯ ПЕРИТОНЕАЛЬНОГО ДИАЛИЗА	Р-Р Д/ПЕРИТОНЕАЛЬНОГО ДИАЛИЗА																							
РАСТВОР ДЛЯ ПРИЕМА ВНУТРЬ ДЛЯ ДЕТЕЙ	Р-Р Д/ПРИЕМА ВНУТРЬ Д/ДЕТ																							
РАСТВОР ДЛЯ ПРИЕМА ВНУТРЬ СПИРТОВОЙ	Р-Р Д/ПРИЕМА ВНУТРЬ СПИРТ																							
РАСТВОР С ГИНЕКОЛОГИЧЕСКОЙ НАСАДКОЙ	Р-Р С ГИНЕК НАСАД-Й																							
РАСТВОР С ГИНЕКОЛОГИЧЕСКОЙ НАСАДКОЙ	Р-Р С ГИНЕК НАСАДКОЙ																							
РАСТВОР С ГИНЕКОЛОГИЧЕСКОЙ НАСАДКОЙ	Р-Р С ГИНЕКОЛОГ НАС																							
СУСПЕНЗИЯ ДЛЯ ИНЪЕКЦИЙ ДЛЯ ВЗРОСЛЫХ	СУСП Д/ИН Д/ВЗРОС																							
СУСПЕНЗИЯ РЕКТАЛЬНАЯ С АППЛИКАТОРОМ	СУСП РЕКТ С АППЛ																							
 ТАБЛЕТКИ ДИСПЕРГИРУЕМЫЕ ДЛЯ ДЕТЕЙ 	 ТАБ ДИСПЕРГИР Д/ДЕТ 																							
 ТАБЛЕТКИ ПОКРЫТЫЕ ОБОЛОЧКОЙ ФОРТЕ 	 ТАБ П/О ФОРТЕ 																							
 ТАБЛЕТКИ ФОРТЕ ПОКРЫТЫЕ ОБОЛОЧКОЙ 	 ТАБ ФОРТЕ П/О 																							
 ТАБЛЕТКИ ШИПУЧИЕ СО ВКУСОМ МАЛИНЫ 	 ТАБ ШИП СО ВКУСОМ МАЛ 																							
ТАБЛЕТКИ ПРОЛОНГИРОВАННОГО ДЕЙСТВИЯ	ТАБ.ПРОЛ.Д-ИЯ																							
ЭКСТРАКТ ДЛЯ ПРИЕМА ВНУТРЬ (ЖИДКИЙ)	ЭКСТР Д/ПРИЕМА ВНУТРЬ																							
ЭМУЛЬСИЯ ДЛЯ ВНУТРИВЕННОГО ВВЕДЕНИЯ	ЭМУЛЬС Д/В/В ВВЕД																							
БАНДАЖ НА КОЛЕННЫЙ СУСТАВ ЭЛАСТИЧНЫЙ	БАНД НА КОЛЕН СУСТ ЭЛАСТ																							
БЮСТГАЛТЕР ДЛЯ БЕРЕМЕННЫХ И КОРМЯЩИХ	БЮСТ Д/БЕРЕМ/КОРМЯЩ																							
для местного применения дозированный	Д/МЕСТН. ПРИМ. ДОЗИР.																							
ЖИДКОСТЬ ДЛЯ ИНГАЛЯЦИОННОЙ АНЕСТЕЗИИ	ЖИДК Д/ИНГАЛЯЦ АНЕСТЕЗИИ																							
КАПСУЛЫ С ПРОЛОНГИРОВАННЫМ ДЕЙСТВИЕМ	КАПС С ПРОЛОНГ ДЕЙСТВ																							
ПРЕЗЕРВАТИВЫ АРОМАТИЗИРАННЫЕ ЦВЕТНЫЕ	ПРЕЗ АРОМАТ ЦВЕТ																							
РАСТВОР ДЛЯ ВНУТРИМЫШЕЧНОГО ВВЕДЕНИЯ	Р-Р Д/ В/М ВВЕД																							
РАСТВОР ДЛЯ ИНЪЕКЦИЙ ГОМЕОПАТИЧЕСКИЙ	Р-Р Д/ ИН ГОМЕОПАТ																							
РАСТВОР ДЛЯ ИНТРАТЕКАЛЬНОГО ВВЕДЕНИЯ	Р-Р Д/ ИНТРАТЕК ВВЕД																							
РАСТВОР ДЛЯ ИНТРАТЕКАЛЬНОГО ВВЕДЕНИЯ	Р-Р Д/ ИНТРАТЕКАЛЬНОГО ВВЕД																							
РАСТВОР ДЛЯ ВНУТРИМЫШЕЧНОГО ВВЕДЕНИЯ	Р-Р Д/В/М ВВЕД																							
раствор для внутримышечного введения	Р-Р Д/В/М ВВЕД.																							
РАСТВОР ДЛЯ ВНУТРИМЫШЕЧНОГО ВВЕДЕНИЯ	Р-Р Д/ИН В/М																							
РАСТВОР ДЛЯ ИНЪЕКЦИЙ ГОМЕОПАТИЧЕСКИЙ	Р-Р Д/ИН ГОМЕОПАТ																							
РАСТВОР ДЛЯ ИНЪЕКЦИЙ ГОМЕОПАТИЧЕСКИЙ	Р-Р Д/ИН ГОМЕОПАТЕСКИЙ																							
РАСТВОР ДЛЯ ИНТРАТЕКАЛЬНОГО ВВЕДЕНИЯ	Р-Р Д/ИНТРАТЕКАЛЬНОГО ВВЕД																							
РАСТВОР С АППЛИКАТОРОМ УРОЛОГИЧЕСКИМ	Р-Р С АППЛ УРОЛ-ИМ																							
РАСТВОР С АППЛИКАТОРОМ УРОЛОГИЧЕСКИМ	Р-Р С АППЛ УРОЛОГ																							
СУСПЕНЗИЯ ДЛЯ ВНУТРИКОЖНОГО ВВЕДЕНИЯ	СУСП Д/ ВНУТРИКОЖ ВВЕД																							
СУСПЕНЗИЯ ДЛЯ ВНУТРИКОЖНОГО ВВЕДЕНИЯ	СУСП Д/В/К/ВВЕД																							
СУСПЕНЗИЯ ДЛЯ ВНУТРИКОЖНОГО ВВЕДЕНИЯ	СУСП Д/В/КОЖНОГО ВВЕД																							
СУСПЕНЗИЯ ДЛЯ ИНГАЛЯЦИЙ ДОЗИРОВАННАЯ	СУСП Д/ИНГ ДОЗ																							
 ТАБЛЕТКИ ДЛЯ РАССАСЫВАНИЯ ЛИМОННЫЕ 	 ТАБ Д/РАССАС ЛИМ 																							
ЛИОФИЛИЗАТ ДЛЯ ПРИГОТОВЛЕНИЯ РАСТВОРА	ЛИОФ-Т Д/ ПРИГ Р-РА																							
ЛИОФИЛИЗАТ ДЛЯ ПРИГОТОВЛЕНИЯ РАСТВОРА	ЛИОФ-Т Д/ПРИГ Р-РА																							
ЛИОФИЛИЗАТ ДЛЯ ПРИГОТОВЛЕНИЯ РАСТВОРА	ЛИОФ-Т Д/ПРИГ-Я Р-РА																							
ПЛАСТЫРЬ ОБЕЗБОЛИВАЮЩИЙ С ПЕРФОРАЦИЕЙ	ПЛАСТ ОБЕЗБОЛ С ПЕРФ																							
РАСТВОР ДЛЯ ВНУТРИКОРОНАРНЫХ ПЕРФУЗИЙ	Р-Р Д/ ВНУТРИКОРОНАР ВВЕД																							
РАСТВОР ДЛЯ ВНУТРИСУСТАВНОГО ВВЕДЕНИЯ	Р-Р Д/ ВНУТРИСУСТАВ ВВЕД																							
РАСТВОР ДЛЯ ПОДКОЖНОГО ВВЕДЕНИЯ ШПРИЦ	Р-Р Д/ П/К ВВЕД ШПР																							
РАСТВОР ДЛЯ ПРИЕМА ВНУТРЬ И ИНГАЛЯЦИЙ	Р-Р Д/ ПРИЕМА ВНУТРЬ И ИНГ																							
РАСТВОР ДЛЯ ПРИЕМА ВНУТРЬ С ДОЗАТОРОМ	Р-Р Д/ ПРИЕМА ВНУТРЬ С ДОЗАТОРОМ																							
РАСТВОР ДЛЯ ВНУТРИКОРОНАРНЫХ ПЕРФУЗИЙ	Р-Р Д/ВНУТРИКОРОНАР ПЕРФУЗ																							
РАСТВОР ДЛЯ ВНУТРИКОРОНАРНЫХ ПЕРФУЗИЙ	Р-Р Д/ВНУТРИКОРОНАРНЫХ ПЕРФУЗ																							
РАСТВОР ДЛЯ ВНУТРИСУСТАВНОГО ВВЕДЕНИЯ	Р-Р Д/ВНУТРИСУСТАВ ВВЕД																							
РАСТВОР ДЛЯ ИНГАЛЯЦИЙ АБСОРБИРОВАННЫЙ	Р-Р Д/ИНГ АБСОРБИР																							
РАСТВОР ДЛЯ ИНТРААМНИАЛЬНОГО ВВЕДЕНИЯ	Р-Р Д/ИНТРААМНИАЛЬНОГО ВВЕД																							
РАСТВОР ДЛЯ ИНФУЗИЙ КОНЦЕНТРИРОВАННЫЙ	Р-Р Д/ИНФ КОНЦ																							
РАСТВОР ДЛЯ ПОДКОЖНОГО ВВЕДЕНИЯ ШПРИЦ	Р-Р Д/П/К ВВЕД ШПРИЦ																							
РАСТВОР ДЛЯ ПРИЕМА ВНУТРЬ И ИНГАЛЯЦИЙ	Р-Р Д/ПРИЕМА ВНУТРЬ И ИНГ																							
РАСТВОР ДЛЯ ПРИЕМА ВНУТРЬ С ДОЗАТОРОМ	Р-Р Д/ПРИЕМА ВНУТРЬ С ДОЗАТ																							
РАСТВОР ДЛЯ ПРИЕМА ВНУТРЬ С ДОЗАТОРОМ	Р-Р Д/ПРИЕМА ВНУТРЬ С ДОЗАТОРОМ																							
СПИРАЛЬ ВНУТРИМАТОЧНАЯ КОЛЬЦЕОБРАЗНАЯ	СПИРАЛЬ ВНУТРИМАТ КОЛЬЦЕОБРАЗ																							
СУППОЗИТОРИИ ВАГИНАЛЬНЫЕ И РЕКТАЛЬНЫЕ	СУПП ВАГ И РЕКТ																							
СУСПЕНЗИЯ ДЛЯ ПРИЕМА ВНУТРЬ ДЛЯ ДЕТЕЙ	СУСП Д/ПРИЕМА ВНУТРЬ Д/ДЕТ																							
 ТАБЛЕТКИ ДЛЯ РАССАСЫВАНИЯ ДЛЯ ДЕТЕЙ 	 ТАБ Д/РАССАС Д/ДЕТ 																							
 ТАБЛЕТКИ ЗАМЕДЛЕННОГО ВЫСВОБОЖДЕНИЯ 	 ТАБ ЗАМЕД ВЫСВОБОЖД 																							
 ТАБЛЕТКИ ПРОЛОНГИРОВАННОГО ДЕЙСТВИЯ 	 ТАБ ПРОЛОНГ ДЕЙСТВ 																							
ТАБЛЕТКИ ПОКРЫТЫЕ ПЛЕНОЧНОЙ ОБОЛОЧКОЙ	ТАБ. П/О ПЛЁН																							
таблетки покрытые пленочной оболочкой	ТАБ. П/О ПЛЁН.																							
таблетки покрытые пленочной оболочкой	ТАБ.П/О ПЛЕН.																							
ТАБЛЕТКИ ПОКРЫТЫЕ ПЛЕНОЧНОЙ ОБОЛОЧКОЙ	ТАБЛ П/П/О																							
ТАБЛЕТКИ ПОКРЫТЫЕ ПЛЕНОЧНОЙ ОБОЛОЧКОЙ	ТАБЛ.П/П/О																							
ТАБЛЕТКИ ПОКРЫТЫЕ ПЛЕНОЧНОЙ ОБОЛОЧКОЙ	тбл п.п.о.																							
ТАБЛЕТКИ ПОКРЫТЫЕ ПЛЕНОЧНОЙ ОБОЛОЧКОЙ	ТБЛ П/П/О																							
ТАБЛЕТКИ ПОКРЫТЫЕ ПЛЕНОЧНОЙ ОБОЛОЧКОЙ	ТБЛ П/П/О.																							
таблетки покрытые пленочной оболочкой	ТБЛ. П/П/О																							
ТАБЛЕТКИ ПОКРЫТЫЕ ПЛЕНОЧНОЙ ОБОЛОЧКОЙ	ТБЛ.П/П/О																							
 Л/П БЕТАБАНТ  (BETABANT) (BETABANT)  	 BETABANT  																							
 УЗНАЙ СЕЙЧАС  (KNOW NOW) (KNOW NOW)  	 KNOW NOW  																							
 МАСКЬЮ БЭБИ АКВА (MASQUE BABY AQUA)  	 MASQUE BABY AQUA  																							
 Ю-ЧЕК БЭБИ ТЕСТ (U-CHECK BABY TEST)  	 U-CHECK BABY TEST  																							
 ВЕДЖЕТЕЙБЛ БЬЮТИ (VEGETABLE BEAUTY)  	 VEGETABLE BEAUTY  																							
ВНУТРИМАТОЧНАЯ ТЕРАПЕВТИЧЕСКАЯ СИСТЕМА	ВНУТРИМАТ ТЕРАПЕВТИЧ СИСТ																							
ЛИОФИЛИЗАТ ДЛЯ ПРИГОТОВЛЕНИЯ СУСПЕНЗИИ	ЛИОФ-Т Д/ ПРИГ СУСП																							
ЛИОФИЛИЗАТ ДЛЯ ПРИГОТОВЛЕНИЯ СУСПЕНЗИИ	ЛИОФ-Т Д/ПРИГ СУСП																							
ЛИОФИЛИЗАТ ДЛЯ ПРИГОТОВЛЕНИЯ СУСПЕНЗИИ	ЛИОФ-Т Д/ПРИГ-Я СУСП																							
ЛИОФИЛИЗАТ ДЛЯ ПРИГОТОВЛЕНИЯ СУСПЕНЗИИ	ЛИОФИЛ Д/ ПРИГ СУСП																							
ПЛАСТЫРЬ ОБЕЗБОЛИВАЮЩИЙ БЕЗ ПЕРФОРАЦИИ	ПЛАСТ ОБЕЗБОЛ Б/ПЕРФ																							
ПРОКЛАДКИ ЕЖЕДНЕВНЫЕ АРОМАТИЗИРОВАННЫЕ	ПРОКЛ ЕЖЕДНЕВ АРОМАТ																							
РАСТВОР ДЛЯ ВНУТРИСОСУДИСТОГО ВВЕДЕНИЯ	Р-Р Д/ ВНУТРИСОСУД ВВЕД																							
РАСТВОР ДЛЯ ПОДКОЖНОГО ВВЕДЕНИЯ ФЛАКОН	Р-Р Д/ П/К ВВЕД ФЛ																							
РАСТВОР ДЛЯ ВНУТРИСОСУДИСТОГО ВВЕДЕНИЯ	Р-Р Д/ВНУТРИСОСУД ВВЕД																							
РАСТВОР ДЛЯ ИНФУЗИЙ ИЗОТОНИЧЕСКИЙ 0 9%	Р-Р Д/ИНФ ИЗОТОН																							
РАСТВОР ОФТАЛЬМОЛОГИЧЕСКИЙ УВЛАЖНЯЮЩИЙ	Р-Р ОФТАЛЬМ УВЛ																							
СБОР РАСТИТЕЛЬНЫЙ - СЫРЬЕ ИЗМЕЛЬЧЕННОЕ	СБОР РАСТИТ - СЫРЬЕ ИЗМЕЛЬЧ																							
СПРЕЙ НАЗАЛЬНЫЙ ДОЗИРОВАННЫЙ ДЛЯ ДЕТЕЙ	СПР НАЗ ДОЗ Д/ДЕТ																							
СУСПЕНЗИЯ ДЛЯ ВНУТРИМЫШЕЧНОГО ВВЕДЕНИЯ	СУСП Д/ В/М ВВЕД																							
СУСПЕНЗИЯ ДЛЯ ВНУТРИМЫШЕЧНОГО ВВЕДЕНИЯ	СУСП Д/ В/М ИН																							
СУСПЕНЗИЯ ДЛЯ ВНУТРИМЫШЕЧНОГО ВВЕДЕНИЯ	СУСП Д/В/М ВВЕД																							
СУСПЕНЗИЯ ДЛЯ ВНУТРИМЫШЕЧНОГО ВВЕДЕНИЯ	СУСП Д/В/М/ИН																							
 ТАБЛЕТКИ ГОМЕОПАТИЧЕСКИЕ ПОДЪЯЗЫЧНЫЕ 	 ТАБ ГОМЕОПАТ ПОДЪЯЗ 																							
 ТАБЛЕТКИ ДЛЯ РАССАСЫВАНИЯ БЕЗ САХАРА 	 ТАБ Д/ РАС Б/С 																							
 ТАБЛЕТКИ ДЛЯ РАССАСЫВАНИЯ БЕЗ САХАРА 	 ТАБ Д/РАС Б/С 																							
 ТАБЛЕТКИ ДЛЯ РАССАСЫВАНИЯ БЕЗ САХАРА 	 ТАБ Д/РАССАС Б/С 																							
 ТАБЛЕТКИ ПОКРЫТЫЕ САХАРНОЙ ОБОЛОЧКОЙ 	 ТАБ П/САХАР/О 																							
 ТАБЛЕТКИ ПОДЪЯЗЫЧНЫЕ ГОМЕОПАТИЧЕСКИЕ 	 ТАБ ПОДЪЯЗ ГОМЕОПАТ 																							
 ФИТОГАСТРОЛ (ЖЕЛУДОЧНО-КИШЕЧНЫЙ СБОР) 	 ФИТОГАСТРОЛ (ЖЕЛУДОЧНО КИШЕЧНЫЙ СБОР) 																							
ГОЛЬФЫ КОМПРЕССИОННЫЕ 2КЛАСС ДЛЯ МУЖЧИН	ГОЛЬФЫ КОМПРЕС 2КЛАСС Д/МУЖ																							
КАПЛИ ГОМЕОПАТИЧЕСКИЕ ДЛЯ ПРИЕМА ВНУТРЬ	КАП ГОМЕОПАТ Д/ПРИЕМА ВНУТРЬ																							
КАПЛИ ДЛЯ ПРИЕМА ВНУТРЬ ГОМЕОПАТИЧЕСКИЕ	КАП Д/ПРИЕМА ВНУТРЬ ГОМЕОПАТ																							
ПОДПЯТОЧНИК САМОКЛЕЯЩИЙСЯ КОРРИГИРУЮЩИЙ	ПОДПЯТОЧ САМОКЛЕЯЩ КОРРИГИР																							
СРЕДСТВО СМАЗЫВАЮЩЕЕ ОФТАЛЬМОЛОГИЧЕСКОЕ	СР-ВО СМАЗ ОФТАЛЬМ																							
СУППОЗИТОРИИ РЕКТАЛЬНЫЕ ГОМЕОПАТИЧЕСКИЕ	СУПП РЕКТ ГОМЕОПАТ																							
СУСПЕНЗИЯ ДЛЯ ЭНДОТРАХЕАЛЬНОГО ВВЕДЕНИЯ	СУСП Д/ЭНДОТРАХЕАЛЬНОГО ВВЕД																							
 ТАБЛЕТКИ ДИСПЕРГИРУЕМЫЕ В ПОЛОСТИ РТА 	 ТАБ ДИСПЕРГИР В ПОЛОС РТА 																							
 ТАБЛЕТКИ ДИСПЕРГИРУЕМЫЕ В ПОЛОСТИ РТА 	 ТАБ ДИСПЕРГИР В ПОЛОСТИ РТА 																							
 ТАБЛЕТКИ ПОКРЫТЫЕ ПЛЕНОЧНОЙ ОБОЛОЧКОЙ 	 ТАБ П/ПЛЕН/О 																							
ТРАНСДЕРМАЛЬНАЯ ТЕРАПЕВТИЧЕСКАЯ СИСТЕМА	ТТС																							
ГЕЛЬ ДЛЯ МЕСТНОГО И НАРУЖНОГО ПРИМЕНЕНИЯ	ГЕЛЬ Д/МЕСТН И НАРУЖ ПРИМ																							
ГЕЛЬ ДЛЯ НАРУЖНОГО И МЕСТНОГО ПРИМЕНЕНИЯ	ГЕЛЬ Д/НАРУЖ И МЕСТН ПРИМ																							
ИМПЛАНТАТ ДЛЯ ИНТРАВИТРЕАЛЬНОГО ВВЕДЕНИЯ	ИМПЛАНТ Д/ИНТРАВИТРЕАЛ ВВЕД																							
КРЕМ ДЛЯ МЕСТНОГО И НАРУЖНОГО ПРИМЕНЕНИЯ	КР Д/МЕСТН И НАРУЖ ПРИМ																							
МАЗЬ ДЛЯ МЕСТНОГО И НАРУЖНОГО ПРИМЕНЕНИЯ	МАЗЬ Д/МЕСТН И НАРУЖ ПРИМ																							
МАЗЬ ДЛЯ НАРУЖНОГО И МЕСТНОГО ПРИМЕНЕНИЯ	МАЗЬ Д/НАРУЖ И МЕСТН ПРИМ																							
ГРАНУЛЫ С ПРОЛОНГИРОВАННЫМ ВЫСВОБОЖДЕНИЕМ	ГРАН С ПРОЛОНГ ВЫСВОБОЖД																							
КАПСУЛЫ С МОДИФИЦИРОВАННЫМ ВЫСВОБОЖДЕНИЕМ	КАПС С МОДИФ ВЫСВОБОЖД																							
КАПСУЛЫ С ПРОЛОНГИРОВАННЫМ ВЫСВОБОЖДЕНИЕМ	КАПС С ПРОЛОНГ ВЫСВОБ-ЕМ																							
КАПСУЛЫ С ПРОЛОНГИРОВАННЫМ ВЫСВОБОЖДЕНИЕМ	КАПС С ПРОЛОНГ ВЫСВОБОЖД																							
КАПСУЛЫ С МОДИФИЦИРОВАННЫМ ВЫСВОБОЖДЕНИЕМ	КАПСУЛЫ С МОДИФИЦ ВЫСВОБОЖД																							
КАПСУЛЫ С МОДИФИЦИРОВАННЫМ ВЫСВОБОЖДЕНИЕМ	КАПСУЛЫ С МОДИФИЦИР ВЫСВОБОЖД																							
КАПСУЛЫ С ПРОЛОНГИРОВАННЫМ ВЫСВОБОЖДЕНИЕМ	КАПСУЛЫ С ПРОЛОНГ ВЫСВОБОЖД																							
КАПСУЛЫ С ПРОЛОНГИРОВАННЫМ ВЫСВОБОЖДЕНИЕМ	КАПСУЛЫ С ПРОЛОНГИР ВЫСВОБОЖД																							
МАЗЬ ДЛЯ НАРУЖНОГО ПРИМЕНЕНИЯ ЖИРНАЯ 0 1%	МАЗЬ Д/НАРУЖ ПРИМ ЖИР																							
МАЗЬ ДЛЯ НАРУЖНОГО ПРИМЕНЕНИЯ И ИНГАЛЯЦИЙ	МАЗЬ Д/НАРУЖ ПРИМ И ИНГ																							
РАСТВОР ДЛЯ ИНЪЕКЦИЙ И ЗАКАПЫВАНИЯ В ГЛАЗ	Р-Р Д/ ИН И ЗАКАП В ГЛАЗ																							
РАСТВОР ДЛЯ ИНФУЗИЙ И МЕСТНОГО ПРИМЕНЕНИЯ	Р-Р Д/ ИНФ И МЕСТН ПРИМ																							
РАСТВОР ДЛЯ ИНФУЗИЙ И ПОДКОЖНОГО ВВЕДЕНИЯ	Р-Р Д/ ИНФ И П/К ВВЕД																							
РАСТВОР ДЛЯ ИНЪЕКЦИЙ И ЗАКАПЫВАНИЯ В ГЛАЗ	Р-Р Д/ИН И ЗАКАП В ГЛАЗ																							
РАСТВОР ДЛЯ ИНЪЕКЦИЙ И ЗАКАПЫВАНИЯ В ГЛАЗ	Р-Р Д/ИН И ЗАКАПЫВАНИЯ В ГЛАЗ																							
РАСТВОР ДЛЯ ИНФУЗИЙ И МЕСТНОГО ПРИМЕНЕНИЯ	Р-Р Д/ИНФ И МЕСТН ПРИМ																							
РАСТВОР ДЛЯ ИНФУЗИЙ И ПОДКОЖНОГО ВВЕДЕНИЯ	Р-Р Д/ИНФ И П/К ВВЕД																							
РАСТВОР ДЛЯ ИНФУЗИЙ И ПОДКОЖНОГО ВВЕДЕНИЯ	Р-Р Д/ИНФ И П/КН ВВЕД																							
РАСТВОР ДЛЯ ИНФУЗИЙ И ПОДКОЖНОГО ВВЕДЕНИЯ	Р-Р Д/ИНФ И П/КОЖНОГО ВВЕД																							
РАСТВОР ДЛЯ МЕСТНОГО ПРИМЕНЕНИЯ СПИРТОВОЙ	Р-Р Д/МЕСТН ПРИМ СПИРТ																							
РАСТВОР ДЛЯ НАРУЖНОГО ПРИМЕНЕНИЯ МАСЛЯНЫЙ	Р-Р Д/НАРУЖ ПРИМ МАСЛ																							
РАСТВОР ДЛЯ ПРИЕМА ВНУТРЬ ГОМЕОПАТИЧЕСКИЙ	Р-Р Д/ПРИЕМА ВНУТРЬ ГОМЕОПАТ																							
ТРУСЫ МЕДИЦИНСКИЕ ЭЛАСТИЧНЫЕ ПОСЛЕРОДОВЫЕ	ТРУСЫ МЕД ЭЛАСТ ПОСЛЕРОД																							
ЭКСТРАКТ ДЛЯ МЕСТНОГО ПРИМЕНЕНИЯ (ЖИДКИЙ)	ЭКСТР Д/МЕСТН ПРИМ (ЖИД)																							
 ГОЛДЛИЛИ ЭКСКЛЮЗИВ (GOLDLILY EXCLUSIVE)  	 GOLDLILY EXCLUSIVE  																							
РАСТВОР ДЛЯ ИНЪЕКЦИЙ ВНУТРИВЕННОЕ ВВЕДЕНИЕ	Р-Р Д/ИН В/ВЕННОЕ ВВЕД																							
РАСТВОР ДЛЯ ИНЪЕКЦИЙ И МЕСТНОГО ПРИМЕНЕНИЯ	Р-Р Д/ИН И МЕСТН ПРИМ																							
РАСТВОР ДЛЯ ИНФУЗИЙ И НАРУЖНОГО ПРИМЕНЕНИЯ	Р-Р Д/ИНФ И НАРУЖ ПРИМ																							
РАСТВОР ДЛЯ НАРУЖНОГО ПРИМЕНЕНИЯ СПИРТОВОЙ	Р-Р Д/НАРУЖ ПРИМ СПИРТ																							
РАСТВОР СПИРТОВОЙ ДЛЯ НАРУЖНОГО ПРИМЕНЕНИЯ	Р-Р СПИРТ Д/НАРУЖ ПРИМ																							
СПРЕЙ ДЛЯ МЕСТНОГО ПРИМЕНЕНИЯ ДОЗИРОВАННЫЙ	СПР Д/ МЕСТН ПРИМ ДОЗ																							
СПРЕЙ ДЛЯ МЕСТНОГО ПРИМЕНЕНИЯ ДОЗИРОВАННЫЙ	СПР Д/МЕСТН ПРИМ ДОЗ																							
 ТАБЛЕТКИ РАПИД-РЕТАРД ПОКРЫТЫЕ ОБОЛОЧКОЙ 	 ТАБ РАП-РЕТ П/О 																							
 ТАБЛЕТКИ С КОНТРОЛИРУЕМЫМ ВЫСВОБОЖДЕНИЕМ 	 ТАБ С КОНТРОЛ ВЫСВОБОЖД 																							
ТАБЛЕТКИ С ПРОЛОНГИРОВАННЫМ ВЫСВОБОЖДЕНИЕМ	ТАБ. С ПРОЛОНГ. ВЫСВ.																							
 Л/П КЕА ДЕРМА  (CARE DERMA) (CARE DERMA)  	 CARE DERMA  																							
ГЕЛЬ ДЛЯ РЕКТАЛЬНОГО И НАРУЖНОГО ПРИМЕНЕНИЯ	ГЕЛЬ Д/РЕКТАЛ И НАРУЖ ПРИМ																							
ЛИОФИЛИЗАТ ДЛЯ ПРИГОТОВЛЕНИЯ ГЛАЗНЫХ КАПЕЛЬ	ЛИОФИЛ Д/ПРИГКАПЕЛЬ ГЛАЗНЫХ																							
МАЗЬ ДЛЯ РЕКТАЛЬНОГО И НАРУЖНОГО ПРИМЕНЕНИЯ	МАЗЬ Д/РЕКТ И НАРУЖ ПРИМ																							
ПОРОШОК ДЛЯ НАРУЖНОГО И МЕСТНОГО ПРИМЕНЕНИЯ	ПОР Д/МЕСТН И НАРУЖ ПРИМ																							
РАСТВОР ДЛЯ ИНЪЕКЦИЙ И НАРУЖНОГО ПРИМЕНЕНИЯ	Р-Р Д/ИН И НАРУЖ ПРИМ																							
РАСТВОР ДЛЯ МЕСТНОГО И НАРУЖНОГО ПРИМЕНЕНИЯ	Р-Р Д/МЕСТН И НАРУЖ ПРИМ																							
РАСТВОР ДЛЯ МЕСТНОГО ПРИМЕНЕНИЯ И ИНГАЛЯЦИЙ	Р-Р Д/МЕСТН ПРИМ И ИНГ																							
РАСТВОР ДЛЯ МЕСТНОГО ПРИМЕНЕНИЯ МАСЛЯНЫЙ 2%	Р-Р Д/МЕСТН ПРИМ МАСЛ																							
СПРЕЙ ДОЗИРОВАННЫЙ ДЛЯ НАРУЖНОГО ПРИМЕНЕНИЯ	СПР ДОЗ Д/НАРУЖ ПРИМ																							
 ТАБЛЕТКИ ДЛЯ ПРИГОТОВЛЕНИЯ ГЛАЗНЫХ КАПЕЛЬ 	 ТАБ Д/ПРИГ ГЛАЗ КАП 																							
 ТАБЛЕТКИ ДЛЯ РАССАСЫВАНИЯ ГОМЕОПАТИЧЕСКИЕ 	 ТАБ Д/РАС ГОМЕОПАТ 																							
 ТАБЛЕТКИ ДЛЯ РАССАСЫВАНИЯ МЕДОВО-ЛИМОННЫЕ 	 ТАБ Д/РАССАС МЕД -ЛИМ 																							
АЭРОЗОЛЬ ДЛЯ МЕСТНОГО И НАРУЖНОГО ПРИМЕНЕНИЯ	АЭРОЗ Д/МЕСТН И НАРУЖ ПРИМ																							
ГРАНУЛЫ ПОКРЫТЫЕ ОБОЛОЧКОЙ ДЛЯ ПРИЕМА ВНУТРЬ	ГРАН П/О																							
ГРАНУЛЫ ПОКРЫТЫЕ ОБОЛОЧКОЙ ДЛЯ ПРИЕМА ВНУТРЬ	ГРАН П/О Д/ПРИЕМА ВНУТРЬ																							
ГРАНУЛЫ ПОКРЫТЫЕ ОБОЛОЧКОЙ ДЛЯ ПРИЕМА ВНУТРЬ	ГРАН ПОКР ОБОЛ Д/ПРИЕМА ВНУТРЬ																							
ГРАНУЛЫ ПОКРЫТЫЕ ОБОЛОЧКОЙ ДЛЯ ПРИЕМА ВНУТРЬ	ГРАН ПОКР ОБОЛОЧ																							
МАЗЬ ДЛЯ МЕСТНОГО ПРИМЕНЕНИЯ ГОМЕОПАТИЧЕСКАЯ	МАЗЬ Д/МЕСТН ПРИМ ГОМЕОПАТ																							
РАСТВОР ДЛЯ ИНГАЛЯЦИЙ И НАРУЖНОГО ПРИМЕНЕНИЯ	Р-Р Д/ ИНГ И НАРУЖ ПРИМ																							
РАСТВОР ДЛЯ ИНЪЕКЦИЙ ВНУТРИМЫШЕЧНОЕ ВВЕДЕНИЕ	Р-Р Д/ИН В/МЫШЕЧНОЕ ВВЕД																							
РАСТВОР ДЛЯ ИНГАЛЯЦИЙ И НАРУЖНОГО ПРИМЕНЕНИЯ	Р-Р Д/ИНГ И НАРУЖ ПРИМ																							
РАСТВОР ДЛЯ НАРУЖНОГО ПРИМЕНЕНИЯ И ИНГАЛЯЦИЙ	Р-Р Д/НАРУЖ ПРИМ И ИНГ																							
СПРЕЙ НАЗАЛЬНЫЙ С АРОМАТОМ КАМФОРЫ И МЕНТОЛА	СПР НАЗ С АРОМАТОМ КАМФ И МЕНТОЛА																							
СУСПЕНЗИЯ ДЛЯ ПРИЕМА ВНУТРЬ СО ВКУСОМ ЛИМОНА	СУСП Д/ПРИЕМА ВНУТРЬ СО ВКУСОМ ЛИМ																							
 ТАБЛЕТКИ С МОДИФИЦИРОВАННЫМ ВЫСВОБОЖДЕНИЕМ 	 ТАБ С МОДИФИЦИР ВЫСВОБОЖД 																							
 ТАБЛЕТКИ С ПРОЛОНГИРОВАННЫМ ВЫСВОБОЖДЕНИЕМ 	 ТАБ С ПРОЛОНГ ВЫСВОБОЖ 																							
 ТАБЛЕТКИ С ПРОЛОНГИРОВАННЫМ ВЫСВОБОЖДЕНИЕМ 	 ТАБ С ПРОЛОНГ ВЫСВОБОЖД 																							
АЭРОЗОЛЬ ДЛЯ МЕСТНОГО ПРИМЕНЕНИЯ ДОЗИРОВАННЫЙ	АЭРОЗ Д/ МЕСТН ПРИМ ДОЗ																							
АЭРОЗОЛЬ ДЛЯ МЕСТНОГО ПРИМЕНЕНИЯ ДОЗИРОВАННЫЙ	АЭРОЗ Д/МЕСТН ПРИМ ДОЗ																							
АЭРОЗОЛЬ ДЛЯ МЕСТНОГО ПРИМЕНЕНИЯ ДОЗИРОВАННЫЙ	АЭРОЗ ДОЗ																							
ГРАНУЛЫ ПОКРЫТЫЕ КИШЕЧНОРАСТВОРИМОЙ ОБОЛОЧКОЙ	ГРАН П/О КИШЕЧНОР-РИМЫЕ																							
ГРАНУЛЫ ПОКРЫТЫЕ КИШЕЧНОРАСТВОРИМОЙ ОБОЛОЧКОЙ	ГРАН ПОКР КИШЕЧНОР-РИМОЙ ОБОЛ																							
ГРАНУЛЫ ПОКРЫТЫЕ КИШЕЧНОРАСТВОРИМОЙ ОБОЛОЧКОЙ	ГРАН ПОКР КИШЕЧНОРАСТВ ОБОЛ																							
КАПЛИ ДЛЯ ПРИЕМА ВНУТРЬ И МЕСТНОГО ПРИМЕНЕНИЯ	КАП Д/ПРИЕМА ВНУТРЬ И МЕСТН ПРИМ																							
МАЗЬ ГОМЕОПАТИЧЕСКАЯ ДЛЯ НАРУЖНОГО ПРИМЕНЕНИЯ	МАЗЬ ГОМЕОПАТ Д/ НАРУЖ ПРИМ																							
МАЗЬ ДЛЯ НАРУЖНОГО ПРИМЕНЕНИЯ ГОМЕОПАТИЧЕСКАЯ	МАЗЬ Д/НАРУЖ ПРИМ ГОМЕОПАТ																							
МАСЛО ДЛЯ МЕСТНОГО ПРИМЕНЕНИЯ ГОМЕОПАТИЧЕСКОЕ	МАСЛО Д/МЕСТН ПРИМ ГОМЕОПАТ																							
НАБОР ДЛЯ ПРИГОТОВЛЕНИЯ РАСТВОРОВ ДЛЯ ИНФУЗИЙ	НАБОР Д/ПРИГ Р-РОВ Д/ИНФ																							
ПЕЛЛЕТЫ И ГРАНУЛЫ ДЛЯ ПРИГОТОВЛЕНИЯ СУСПЕНЗИИ	ПЕЛЛЕТЫ И ГРАН Д/ПРИГ СУСП																							
ПОРОШОК ДЛЯ ИНГАЛЯЦИЙ ДОЗИРОВАННЫЙ ТУРБУХАЛЕР	ПОР Д/ИНГ ДОЗ ТУРБУХАЛЕР																							
РАСТВОР ДЛЯ ВНУТРИМЫШЕЧНОГО ВВЕДЕНИЯ МАСЛЯНЫЙ	Р-Р Д/ В/М ВВЕД МАСЛ																							
РАСТВОР ДЛЯ ВНУТРИМЫШЕЧНОГО ВВЕДЕНИЯ МАСЛЯНЫЙ	Р-Р Д/В/М ВВЕД МАСЛ																							
РАСТВОР ДЛЯ ВНУТРЕННЕГО И МЕСТНОГО ПРИМЕНЕНИЯ	Р-Р Д/ВНУТР И МЕСТН ПРИМ																							
РАСТВОР ДЛЯ ВНУТРЕННЕГО И МЕСТНОГО ПРИМЕНЕНИЯ	Р-Р Д/ВНУТР/МЕСТН ПРИМ																							
 ТАБЛЕТКИ ДЛЯ РАССАСЫВАНИЯ ЧЕРНОСМОРОДИНОВЫЕ 	 ТАБ Д/РАССАС ЧЕРНОСМОРОД 																							
 ТАБЛЕТКИ ПОКРЫТЫЕ ОБОЛОЧКОЙ ГОМЕОПАТИЧЕСКИЕ 	 ТАБ П/О ГОМЕОПАТ 																							
 ТАБЛЕТКИ ФОРТЕ ПОКРЫТЫЕ ПЛЕНОЧНОЙ ОБОЛОЧКОЙ 	 ТАБ ФОРТЕ П/ПЛЕН/О 																							
 ТАБЛЕТКИ ШИПУЧИЕ ПРОЛОНГИРОВАННОГО ДЕЙСТВИЯ 	 ТАБ ШИП ПРОЛОНГ ДЕЙСТВ 																							
ЭМУЛЬСИЯ ДЛЯ ИНГАЛЯЦИЙ И НАРУЖНОГО ПРИМЕНЕНИЯ	ЭМУЛЬС Д/ИНГ И НАРУЖ ПРИМ																							
КАПЛИ ДЛЯ ПРИЕМА ВНУТРЬ И НАРУЖНОГО ПРИМЕНЕНИЯ	КАП Д/ПРИЕМА ВНУТРЬ И НАРУЖ ПРИМ																							
МАСЛО ДЛЯ ПРИЕМА ВНУТРЬ И НАРУЖНОГО ПРИМЕНЕНИЯ	МАСЛО Д/ПРИЕМА ВНУТРЬ И НАРУЖ ПРИМ																							
ПОРОШОК ДЛЯ ПРИГОТОВЛЕНИЯ РАСТВОРА ДЛЯ ИНФУЗИЙ	ПОР Д/ ПРИГ Р-РА Д/ ИНФ																							
ПОРОШОК ДЛЯ ПРИГОТОВЛЕНИЯ РАСТВОРА ДЛЯ ИНФУЗИЙ	ПОР Д/ПРИГ Р-РА Д/ИНФ																							
ПОРОШОК ДЛЯ ПРИГОТОВЛЕНИЯ РАСТВОРА ДЛЯ ИНФУЗИЙ	ПОР Д/ПРИГ Р-РА Д/ИНФУЗ																							
РАСТВОР ДЛЯ ВНУТРЕННЕГО И НАРУЖНОГО ПРИМЕНЕНИЯ	Р-Р Д/ ВНУТР И МЕСТН ПРИМ																							
РАСТВОР ДЛЯ ИНФУЗИЙ И ВНУТРИМЫШЕЧНОГО ВВЕДЕНИЯ	Р-Р Д/ ИНФ И В/М ВВЕД																							
РАСТВОР ДЛЯ ПОДКОЖНОГО ВВЕДЕНИЯ В ШПРИЦ-АМПУЛЕ	Р-Р Д/ П/К ВВЕД ШПР -АМП																							
РАСТВОР ДЛЯ ИНФУЗИЙ И ВНУТРИМЫШЕЧНОГО ВВЕДЕНИЯ	Р-Р Д/ИНФ И В/М ВВЕД																							
РАСТВОР ДЛЯ ИНФУЗИЙ И ВНУТРИМЫШЕЧНОГО ВВЕДЕНИЯ	Р-Р Д/ИНФ И В/МЫШЕЧНОГО ВВЕД																							
СУСПЕНЗИЯ ДЛЯ ПОДКОЖНОГО И НАЗАЛЬНОГО ВВЕДЕНИЯ	СУСП Д/П/К И НАЗ ВВЕД																							
 ТАБЛЕТКИ РЕТАРД ПОКРЫТЫЕ ПЛЕНОЧНОЙ ОБОЛОЧКОЙ 	 ТАБ РЕТ П/ПЛЕН/О 																							
 ТАБЛЕТКИ ШИПУЧИЕ ДЛЯ ОЧИСТКИ ЗУБНЫХ ПРОТЕЗОВ 	 ТАБ ШИП Д/ОЧИСТ ЗУБНЫХ ПРОТЕЗОВ 																							
ТАБЛЕТКИ ПОКРЫТЫЕ ОБОЛОЧКОЙ КИШЕЧНОРАСТВОРИМЫЕ	ТБЛ П/О КИШЕЧНОР.																							
ТАБЛЕТКИ ПОКРЫТЫЕ ОБОЛОЧКОЙ КИШЕЧНОРАСТВОРИМЫЕ	ТБЛ П/П/О КИШЕЧНОР																							
БАНДАЖ НА ГОЛЕНОСТОПНЫЙ СУСТАВ 1КЛАСС КОМПРЕСИИ	БАНД НА ГОЛЕНОСТОП СУСТ 1КЛАСС КОМПРЕССИИ																							
БЮСТГАЛЬТЕР МЕДИЦИНСКИЙ ЭЛАСТИЧНЫЙ ПОСЛЕРОДОВЫЙ	БЮСТ МЕД ЭЛАСТ ПОСЛЕРОД																							
ПОРОШОК ДЛЯ ПРИГОТОВЛЕНИЯ ВАГИНАЛЬНОГО РАСТВОРА	ПОР Д/ ПРИГ Р-РА ВАГ																							
ПОРОШОК ДЛЯ ПРИГОТОВЛЕНИЯ РАСТВОРА ДЛЯ ИНЪЕКЦИЙ	ПОР Д/ ПРИГ Р-РА Д/ ИН																							
ПОРОШОК ДЛЯ ПРИГОТОВЛЕНИЯ ВАГИНАЛЬНОГО РАСТВОРА	ПОР Д/ПРИГ ВАГ Р-РА																							
ПОРОШОК ДЛЯ ПРИГОТОВЛЕНИЯ РАСТВОРА ДЛЯ ИНЪЕКЦИЙ	ПОР Д/ПРИГ Р-РА Д/ИН																							
ПОРОШОК ДЛЯ ПРИГОТОВЛЕНИЯ РАСТВОРА ДЛЯ ИНЪЕКЦИЙ	ПОР Д/ПРИГ Р-РА Д/ИНЪЕКЦ																							
ПОРОШОК ДЛЯ ПРИЕМА ВНУТРЬ И МЕСТНОГО ПРИМЕНЕНИЯ	ПОР Д/ПРИЕМА ВНУТРЬ И МЕСТН ПРИМ																							
РАСТВОР ДЛЯ ВНУТРИВЕННОГО И ПОДКОЖНОГО ВВЕДЕНИЯ	Р-Р Д/ В/В И П/К ВВЕД																							
РАСТВОР ДЛЯ ВНУТРИВЕННОГО И ПОДКОЖНОГО ВВЕДЕНИЯ	Р-Р Д/В/В И П/К ВВЕД																							
РАСТВОР ДЛЯ ПОДКОЖНОГО И ВНУТРИВЕННОГО ВВЕДЕНИЯ	Р-Р Д/П/К И В/В ВВЕД																							
РАСТВОР ДЛЯ ПРИЕМА ВНУТРЬ И МЕСТНОГО ПРИМЕНЕНИЯ	Р-Р Д/ПРИЕМА ВНУТРЬ И МЕСТН ПРИМ																							
 СИРОП ОТ КАШЛЯ С ПОДОРОЖНИКОМ И МАТЬ-И-МАЧЕХОЙ 	 СИРОП ОТ КАШЛЯ С ПОДОРОЖНИКОМ И МАТЬ И МАЧЕХОЙ 																							
АНТИПЕРСПИРАНТ ПИТАТЕЛЬНЫЙ С ВИТАМИНАМИ АЭРОЗОЛЬ	АНТИПЕРСПИР ПИТАТ С ВИТАМ АЭРОЗ																							
БАЛЬЗАМ ДЛЯ ПРИЕМА ВНУТРЬ И НАРУЖНОГО ПРИМЕНЕНИЯ	БАЛЬЗ Д/ПРИЕМА ВНУТРЬ И НАРУЖ ПРИМ																							
ЛИОФИЛИЗАТ ДЛЯ ПРИГОТОВЛЕНИЯ НАЗАЛЬНОГО РАСТВОРА	ЛИОФИЛ Д/ПРИГНАЗ Р-РА																							
ПОРОШОК ДЛЯ ПРИГОТОВЛЕНИЯ РАСТВОРА ДЛЯ ИНГАЛЯЦИЙ	ПОР Д/ ПРИГ Р-РА Д/ ИНГ																							
ПОРОШОК ДЛЯ ПРИГОТОВЛЕНИЯ СУСПЕНЗИИ ДЛЯ ИНЪЕКЦИЙ	ПОР Д/ ПРИГ СУСП Д/ ИН																							
ПОРОШОК ДЛЯ ПРИГОТОВЛЕНИЯ РАСТВОРА ДЛЯ ИНГАЛЯЦИЙ	ПОР Д/ПРИГ Р-РА Д/ИНГ																							
ПОРОШОК ДЛЯ ПРИГОТОВЛЕНИЯ СУСПЕНЗИИ ДЛЯ ИНЪЕКЦИЙ	ПОР Д/ПРИГ СУСП Д/ИН																							
ПОРОШОК ДЛЯ ПРИГОТОВЛЕНИЯ СУСПЕНЗИИ ДЛЯ ИНЪЕКЦИЙ	ПОР Д/ПРИГ СУСП Д/ИНЪЕКЦ																							
РАСТВОР ДЛЯ ИНТРАНАЗАЛЬНОГО ВВЕДЕНИЯ И ИНГАЛЯЦИЙ	Р-Р Д/ ИНТРАНАЗ ВВЕД И ИНГ																							
РАСТВОР ДЛЯ ИНТРАНАЗАЛЬНОГО ВВЕДЕНИЯ И ИНГАЛЯЦИЙ	Р-Р Д/ИНТРАНАЗ ВВЕД И ИНГ																							
РАСТВОР ДЛЯ ПРИЕМА ВНУТРЬ И НАРУЖНОГО ПРИМЕНЕНИЯ	Р-Р Д/ПРИЕМА ВНУТРЬ И НАРУЖ ПРИМ																							
РАСТВОР ДЛЯ ПРИЕМА ВНУТРЬ И НАРУЖНОГО ПРИМЕНЕНИЯ	Р-Р Д/ПРИЕМА ВНУТРЬ И НАРУЖ ПРИМ СПИРТ																							
 ТАБЛЕТКИ КИШЕЧНОРАСТВОРИМЫЕ ПОКРЫТЫЕ ОБОЛОЧКОЙ 	 ТАБ ПОКР К/Р-РИМОЙ ОБОЛ 																							
ГОЛЬФЫ КОМПРЕССИОННЫЕ 1КЛАСС ДЛЯ ПУТЕШЕСТВЕННИКОВ	ГОЛЬФЫ КОМПРЕС 1КЛАСС Д/ПУТЕШЕСТ																							
КОНЦЕНТРАТ ДЛЯ ПРИГОТОВЛЕНИЯ РАСТВОРА ДЛЯ ИНФУЗИЙ	КОНЦ Д/ПРИГ Р-РА Д/ ИНФ																							
ЛИОФИЛИЗАТ ДЛЯ ПРИГОТОВЛЕНИЯ РАСТВОРА ДЛЯ ИНФУЗИЙ	ЛИОФ-Т Д/ ПРИГ Р-РА Д/ ИНФ																							
ЛИОФИЛИЗАТ ДЛЯ ПРИГОТОВЛЕНИЯ РАСТВОРА ДЛЯ ИНФУЗИЙ	ЛИОФ-Т Д/ПРИГ Р-РА Д/ ИНФ																							
ЛИОФИЛИЗАТ ДЛЯ ПРИГОТОВЛЕНИЯ РАСТВОРА ДЛЯ ИНФУЗИЙ	ЛИОФ-Т Д/ПРИГ-Я Р-РА Д/ИНФ																							
ЛИОФИЛИЗАТ ДЛЯ ПРИГОТОВЛЕНИЯ РАСТВОРА ДЛЯ ИНФУЗИЙ	ЛИОФИЛ Д/ ПРИГ Р-РА Д/ ИНФ																							
ЛИОФИЛИЗАТ ДЛЯ ПРИГОТОВЛЕНИЯ РАСТВОРА ДЛЯ ИНФУЗИЙ	ЛИОФИЛ Д/ПРИГ Р-РА Д/ИНФ																							
РАСТВОР ДЛЯ ВНУТРИМЫШЕЧНОГО И ПОДКОЖНОГО ВВЕДЕНИЯ	Р-Р Д/ В/М И П/К ВВЕД																							
РАСТВОР ДЛЯ НАРУЖНОГО ПРИМЕНЕНИЯ ПЛЕНКООБРАЗУЮЩИЙ	Р-Р Д/ НАРУЖ ПРИМ ПЛЕНКООБРАЗ																							
РАСТВОР ДЛЯ ВНУТРИМЫШЕЧНОГО И ПОДКОЖНОГО ВВЕДЕНИЯ	Р-Р Д/В/М И П/К ВВЕД																							
РАСТВОР ДЛЯ НАРУЖНОГО ПРИМЕНЕНИЯ ПЛЕНКООБРАЗУЮЩИЙ	Р-Р Д/НАРУЖ ПРИМ ПЛЕНКООБРАЗ																							
СПРЕЙ ДОЗИРОВАННЫЙ ДЛЯ СУБЛИНГВАЛЬНОГО ПРИМЕНЕНИЯ	СПР Д/СУБЛИНГВ ПРИМ																							
СУСПЕНЗИЯ ДЛЯ ПРИГОТОВЛЕНИЯ РАСТВОРА ДЛЯ ИНЪЕКЦИЙ	СУСП Д/ ПРИГ Р-РА Д/ИН																							
СУСПЕНЗИЯ ДЛЯ ПРИГОТОВЛЕНИЯ РАСТВОРА ДЛЯ ИНЪЕКЦИЙ	СУСП Д/ПРИГ Р-РА Д/ИН																							
КОНЦЕНТРАТ ДЛЯ ПРИГОТОВЛЕНИЯ РАСТВОРА ДЛЯ ИНЪЕКЦИЙ	КОНЦ Д/ПРИГ Р-РА Д/ ИН																							
КОНЦЕНТРАТ ДЛЯ ПРИГОТОВЛЕНИЯ РАСТВОРА ДЛЯ ИНЪЕКЦИЙ	КОНЦ Д/ПРИГ Р-РА Д/ИН																							
КОНЦЕНТРАТ ДЛЯ ПРИГОТОВЛЕНИЯ РАСТВОРА ДЛЯ ИНЪЕКЦИЙ	КОНЦ Д/ПРИГ Р-РА Д/ИНЪЕК																							
ЛИОФИЛИЗАТ ДЛЯ ПРИГОТОВЛЕНИЯ РАСТВОРА ДЛЯ ИНЪЕКЦИЙ	ЛИОФ-Т Д/ ПРИГ Р-РА Д/ ИН																							
ЛИОФИЛИЗАТ ДЛЯ ПРИГОТОВЛЕНИЯ СУСПЕНЗИИ ДЛЯ ИНФУЗИЙ	ЛИОФ-Т Д/ ПРИГ СУСП Д/ ИНФ																							
ЛИОФИЛИЗАТ ДЛЯ ПРИГОТОВЛЕНИЯ РАСТВОРА ДЛЯ ИНЪЕКЦИЙ	ЛИОФ-Т Д/ПРИГ Р-РА Д/ ИН																							
ЛИОФИЛИЗАТ ДЛЯ ПРИГОТОВЛЕНИЯ СУСПЕНЗИИ ДЛЯ ИНФУЗИЙ	ЛИОФ-Т Д/ПРИГ СУСП Д/ ИНФ																							
ЛИОФИЛИЗАТ ДЛЯ ПРИГОТОВЛЕНИЯ РАСТВОРА ДЛЯ ИНЪЕКЦИЙ	ЛИОФ-Т Д/ПРИГ-Я Р-РА Д/ИН																							
ЛИОФИЛИЗАТ ДЛЯ ПРИГОТОВЛЕНИЯ СУСПЕНЗИИ ДЛЯ ИНФУЗИЙ	ЛИОФ-Т Д/ПРИГ-Я СУСП Д/ИНФУЗ																							
ЛИОФИЛИЗАТ ДЛЯ ПРИГОТОВЛЕНИЯ РАСТВОРА ДЛЯ ИНЪЕКЦИЙ	ЛИОФ.Д/ПРИГ.Р-РА Д/ИН.																							
ЛИОФИЛИЗАТ ДЛЯ ПРИГОТОВЛЕНИЯ РАСТВОРА ДЛЯ ИНЪЕКЦИЙ	ЛИОФИЛ Д/ ПРИГ Р-РА Д/ ИН																							
ЛИОФИЛИЗАТ ДЛЯ ПРИГОТОВЛЕНИЯ СУСПЕНЗИИ ДЛЯ ИНФУЗИЙ	ЛИОФИЛ Д/ ПРИГ СУСП Д/ ИНФ																							
ЛИОФИЛИЗАТ ДЛЯ ПРИГОТОВЛЕНИЯ РАСТВОРА ДЛЯ ИНЪЕКЦИЙ	ЛИОФИЛ Д/ПРИГ Р-РА Д/ИН																							
ЛИОФИЛИЗАТ ДЛЯ ПРИГОТОВЛЕНИЯ СУСПЕНЗИИ ДЛЯ ИНФУЗИЙ	ЛИОФИЛ Д/ПРИГ СУСП Д/ИНФ																							
РАСТВОР ДЛЯ ВНУТРИВЕННОГО ВВЕДЕНИЯ И ПРИЕМА ВНУТРЬ	Р-Р Д/В/В ВВЕД И ПРИЕМА ВНУТРЬ																							
РАСТВОР ДЛЯ ИНФУЗИЙ В РАСТВОРЕ НАТРИЯ ХЛОРИДА 0 9%	Р-Р Д/ИНФ В 0,9% Р-РЕ НАТРИЯ ХЛОРИДА																							
ЭМУЛЬСИЯ ДЛЯ ИНТРАВАГИНАЛЬНОГО ВВЕДЕНИЯ В КАПСУЛАХ	ЭМУЛЬС Д/ИНТРАВАГ ВВЕД В КАПС																							
ЛИОФИЛИЗАТ ДЛЯ ПРИГОТОВЛЕНИЯ СУСПЕНЗИИ ДЛЯ ИНЪЕКЦИЙ	ЛИОФИЛ Д/ПРИГ СУСП Д/ИН																							
ПАСТА ДЛЯ ПРИГОТОВЛЕНИЯ СУСПЕНЗИИ ДЛЯ ПРИЕМА ВНУТРЬ	ПАСТА Д/ПРИГ СУСП Д/ПРИЕМА ВНУТРЬ																							
РАСТВОР ДЛЯ ВНУТРИПОЛОСТНОГО И НАРУЖНОГО ПРИМЕНЕНИЯ	Р-Р Д/ ВНУТРИПОЛОСТ ВВЕД И НАРУЖ ПРИМ																							
РАСТВОР ДЛЯ ВНУТРИПОЛОСТНОГО И НАРУЖНОГО ПРИМЕНЕНИЯ	Р-Р Д/ВНУТРИПОЛОСТ ВВЕД И НАРУЖ ПР-Я																							
РАСТВОР ДЛЯ ВНУТРИПОЛОСТНОГО И НАРУЖНОГО ПРИМЕНЕНИЯ	Р-Р Д/ВНУТРИПОЛОСТ ВВЕД И НАРУЖ ПРИМ																							
РАСТВОР ДЛЯ ВНУТРИПОЛОСТНОГО И НАРУЖНОГО ПРИМЕНЕНИЯ	Р-Р Д/ВНУТРИПОЛОСТ ВВЕД И НАРУЖ ПРИМ АМП																							
РАСТВОР ДЛЯ ВНУТРИПОЛОСТНОГО И НАРУЖНОГО ПРИМЕНЕНИЯ	Р-Р Д/ВНУТРИПОЛОСТ ВВЕД И НАРУЖ ПРИМ ФЛ С КРЫШК/КАП-ЦЕЙ																							
РАСТВОР ДЛЯ ВНУТРИПОЛОСТНОГО И НАРУЖНОГО ПРИМЕНЕНИЯ	Р-Р Д/ВНУТРИПОЛОСТ И НАРУЖ ПРИМ																							
СУСПЕНЗИЯ ДЛЯ ВНУТРИМЫШЕЧНОГО И ПОДКОЖНОГО ВВЕДЕНИЯ	СУСП Д/В/М И П/К ВВЕД																							
ГРАНУЛЫ ДЛЯ ПРИГОТОВЛЕНИЯ РАСТВОРА ДЛЯ ПРИЕМА ВНУТРЬ	ГРАН Д/ ПРИГ Р-РА Д/ ПРИЕМА ВНУТРЬ																							
ГРАНУЛЫ ДЛЯ ПРИГОТОВЛЕНИЯ РАСТВОРА ДЛЯ ПРИЕМА ВНУТРЬ	ГРАН Д/ПРИГ Р-РА																							
ГРАНУЛЫ ДЛЯ ПРИГОТОВЛЕНИЯ РАСТВОРА ДЛЯ ПРИЕМА ВНУТРЬ	ГРАН Д/ПРИГ Р-РА Д/ ПРИЕМА ВНУТРЬ																							
ГРАНУЛЫ ДЛЯ ПРИГОТОВЛЕНИЯ РАСТВОРА ДЛЯ ПРИЕМА ВНУТРЬ	ГРАН Д/ПРИГ Р-РА Д/ПРИЕМА ВНУТРЬ																							
ГРАНУЛЫ ЗАМЕДЛЕННОГО ВЫСВОБОЖДЕНИЯ ДЛЯ ПРИЕМА ВНУТРЬ	ГРАН ЗАМЕДЛ ВЫСВОБ Д/ПРИЕМА ВНУТРЬ																							
ГРАНУЛЫ ЗАМЕДЛЕННОГО ВЫСВОБОЖДЕНИЯ ДЛЯ ПРИЕМА ВНУТРЬ	ГРАН ЗАМЕДЛ ВЫСВОБОЖД Д/ПРИЕМА ВНУТРЬ																							
ПОРОШОК ДЛЯ ПРИГОТОВЛЕНИЯ РАСТВОРА ДЛЯ ПРИЕМА ВНУТРЬ	ПОР Д/ ПРИГ Р-РА Д/ ПРИЕМА ВНУТРЬ																							
ПОРОШОК ДЛЯ ПРИГОТОВЛЕНИЯ РАСТВОРА ДЛЯ ПРИЕМА ВНУТРЬ	ПОР Д/ПРИГ Р-РА Д/ПРИЕМА ВНУТРЬ																							
порошок для приготовления раствора для приема внутрь	ПОР.Д/Р-РА Д/ПРИЕМА ВНУТРЬ																							
РАСТВОР ДЛЯ ВНУТРИВЕННОГО И ВНУТРИМЫШЕЧНОГО ВВЕДЕНИЯ	Р-Р В/В В/М																							
РАСТВОР ДЛЯ ВНУТРИМЫШЕЧНОГО И ВНУТРИВЕННОГО ВВЕДЕНИЯ	Р-Р В/В И В/М ВВЕД.																							
РАСТВОР ДЛЯ ВНУТРИВЕННОГО И ВНУТРИМЫШЕЧНОГО ВВЕДЕНИЯ	Р-Р Д/ В/В И В/М ВВДЕНИЯ																							
РАСТВОР ДЛЯ ВНУТРИВЕННОГО И ВНУТРИМЫШЕЧНОГО ВВЕДЕНИЯ	Р-Р Д/ В/В И В/М ВВЕД																							
РАСТВОР ДЛЯ ВНУТРИМЫШЕЧНОГО И ВНУТРИВЕННОГО ВВЕДЕНИЯ	Р-Р Д/ В/М И В/В ВВЕД																							
РАСТВОР ДЛЯ ВНУТРИВЕННОГО И ВНУТРИМЫШЕЧНОГО ВВЕДЕНИЯ	Р-Р Д/В/В И В/М ВВЕД																							
РАСТВОР ДЛЯ ВНУТРИМЫШЕЧНОГО ВВЕДЕНИЯ ГОМЕОПАТИЧЕСКИЙ	Р-Р Д/В/М ВВЕД ГОМЕОПАТ																							
РАСТВОР ДЛЯ ВНУТРИМЫШЕЧНОГО И ВНУТРИВЕННОГО ВВЕДЕНИЯ	Р-Р Д/В/М И В/В ВВЕД																							
РАСТВОР ДЛЯ МЕСТНОГО И НАРУЖНОГО ПРИМЕНЕНИЯ МАСЛЯНЫЙ	Р-Р Д/МЕСТН И НАРУЖ ПРИМ МАСЛ																							
РАСТВОР ДЛЯ ПАРАБУЛЬБАРНОГО И ВНУТРИВЕННОГО ВВЕДЕНИЯ	Р-Р Д/ПАРАБУЛЬБАР И В/В ВВЕД																							
СУППОЗИТОРИИ ДЛЯ ВАГИНАЛЬНОГО И РЕКТАЛЬНОГО ВВЕДЕНИЯ	СУПП Д/ВАГ И РЕКТ ВВЕД																							
ГРАНУЛЫ ДЛЯ ПРИГОТОВЛЕНИЯ СУСПЕНЗИИ ДЛЯ ПРИЕМА ВНУТРЬ	ГРАН Д/ ПРИГ СУСП																							
ГРАНУЛЫ ДЛЯ ПРИГОТОВЛЕНИЯ СУСПЕНЗИИ ДЛЯ ПРИЕМА ВНУТРЬ	ГРАН Д/ПРИГ СУСП																							
ГРАНУЛЫ ДЛЯ ПРИГОТОВЛЕНИЯ СУСПЕНЗИИ ДЛЯ ПРИЕМА ВНУТРЬ	ГРАН Д/ПРИГ СУСП Д/ПРИЕМА ВНУТРЬ																							
ПОРОШОК ДЛЯ ПРИГОТОВЛЕНИЯ СУСПЕНЗИИ ДЛЯ ПРИЕМА ВНУТРЬ	ПОР Д/ ПРИГ СУСП Д/ ПРИЕМА ВНУТРЬ																							
ПОРОШОК ДЛЯ ПРИГОТОВЛЕНИЯ СУСПЕНЗИИ ДЛЯ ПРИЕМА ВНУТРЬ	ПОР Д/ПРИГ СУСП Д/ПРИЕМА ВНУТРЬ																							
РАСТВОР ДЛЯ МЕСТНОГО И НАРУЖНОГО ПРИМЕНЕНИЯ СПИРТОВОЙ	Р-Р Д/МЕСТН И НАРУЖ ПРИМ СПИРТ																							
 ТАБЛЕТКИ ДЛЯ РАССАСЫВАНИЯ ГОМЕОПАТИЧЕСКИЕ ДЛЯ ДЕТЕЙ 	 ТАБ Д/РАС ГОМЕОПАТ Д/ДЕТ 																							
РАСТВОР ДЛЯ ПОДКОЖНОГО И СУБКОНЪЮНКТИВАЛЬНОГО ВВЕДЕНИЯ	Р-Р Д/ П/К И СУБКОНЪЮНКТИВ ВВЕД																							
РАСТВОР ДЛЯ ПОДКОЖНОГО ВВЕДЕНИЯ КАРТРИДЖ В ШПРИЦ-РУЧКЕ	Р-Р Д/П/К ВВЕД КАРТРИДЖ В ШПРИЦ-РУЧКЕ																							
РАСТВОР ДЛЯ ПОДКОЖНОГО И СУБКОНЪЮНКТИВАЛЬНОГО ВВЕДЕНИЯ	Р-Р Д/П/К И СУБКОНЪЮНКТИВ ВВЕД																							
РАСТВОР ДЛЯ ПОДКОЖНОГО И СУБКОНЪЮНКТИВАЛЬНОГО ВВЕДЕНИЯ	Р-Р Д/П/К И СУБКОНЪЮНКТИВАЛ ВВЕД																							
 ТАБЛЕТКИ ПОКРЫТЫЕ КИШЕЧНОРАСТВОРИМОЙ ОБОЛОЧКОЙ ФОРТЕ 	 ТАБ ПОКР К/Р-РИМОЙ ОБОЛ ФОРТЕ 																							
 ТАБЛЕТКИ КИШЕЧНОРАСТВОРИМЫЕ ПОКРЫТЫЕ ОБОЛОЧКОЙ ФОРТЕ 	 ТАБ ПОКР КИШЕЧНОР-РИМОЙ ОБОЛ ФОРТЕ 																							
АЭРОЗОЛЬ ДЛЯ ИНГАЛЯЦИЙ ДОЗИРОВАННЫЙ АКТИВИРУЕМЫЙ ВДОХОМ	АЭРОЗ Д/ ИНГ ДОЗ AКТИВИРУЕМЫЙ ВДОХОМ																							
АЭРОЗОЛЬ ДЛЯ ИНГАЛЯЦИЙ ДОЗИРОВАННЫЙ АКТИВИРУЕМЫЙ ВДОХОМ	АЭРОЗ Д/ИНГ ДОЗ АКТИВ ВДОХОМ																							
АЭРОЗОЛЬ ДЛЯ ИНГАЛЯЦИЙ ДОЗИРОВАННЫЙ АКТИВИРУЕМЫЙ ВДОХОМ	АЭРОЗ Д/ИНГ ДОЗ АКТИВИР ВДОХОМ																							
ГЕЛЬ ДЛЯ ПОДКОЖНОГО ВВЕДЕНИЯ ПРОЛОНГИРОВАННОГО ДЕЙСТВИЯ	ГЕЛЬ Д/П/К ВВЕД ПРОЛОНГ ДЕЙСТВ																							
КОНЦЕНТРАТ ДЛЯ ПРИГОТОВЛЕНИЯ РАСТВОРА ДЛЯ ПРИЕМА ВНУТРЬ	КОНЦ Д/ПРИГ Р-РА Д/ПРИЕМА ВНУТРЬ																							
ЛИОФИЛИЗАТ ДЛЯ ПРИГОТОВЛЕНИЯ РАСТВОРА ДЛЯ ПРИЕМА ВНУТРЬ	ЛИОФИЛ Д/ПРИГ Р-РА Д/ПРИЕМА ВНУТРЬ																							
МАСЛО ДЛЯ ПРИЕМА ВНУТРЬ МЕСТНОГО И НАРУЖНОГО ПРИМЕНЕНИЯ	МАСЛО Д/ ПРИЕМА ВНУТРЬ МЕСТН И НАРУЖ ПРИМ																							
 ТАБЛЕТКИ ПОКРЫТЫЕ КИШЕЧНОРАСТВОРИМОЙ ВОДНОЙ ОБОЛОЧКОЙ 	 ТАБ ПОКР КИШЕЧНОР-РИМОЙ ВОДНОЙ ОБОЛ 																							
ЭКСТРАКТ ДЛЯ ПРИЕМА ВНУТРЬ И МЕСТНОГО ПРИМЕНЕНИЯ ЖИДКИЙ	ЭКСТР Д/МЕСТН ПРИМ И ПРИЕМА ВНУТРЬ (ЖИД)																							
БАНДАЖ КОМПРЕССИОННЫЙ ЭЛАСТИЧНЫЙ НА ГОЛЕНОСТОПНЫЙ СУСТАВ	БАНД КОМПРЕСС ЭЛАСТ НА ГОЛЕНОСТОП СУСТ																							
ЛИОФИЛИЗАТ ДЛЯ ПРИГОТОВЛЕНИЯ СУСПЕНЗИИ ДЛЯ ПРИЕМА ВНУТРЬ	ЛИОФИЛ Д/ПРИГ СУСПД/ПРИЕМА ВНУТРЬ																							
МАЗЬ ДЛЯ НАРУЖНОГО И МЕСТНОГО ПРИМЕНЕНИЯ ГОМЕОПАТИЧЕСКАЯ	МАЗЬ Д/МЕСТН И НАРУЖ ПРИМ ГОМЕОПАТ																							
РАСТВОР ДЛЯ ВНУТРИВЕННОГО И ВНУТРИАРТЕРИАЛЬНОГО ВВЕДЕНИЯ	Р-Р Д/ В/В И В/А ВВЕД																							
РАСТВОР ДЛЯ ВНУТРИВЕННОГО И ВНУТРИАРТЕРИАЛЬНОГО ВВЕДЕНИЯ	Р-Р Д/В/В И В/А ВВЕД																							
РАСТВОР ДЛЯ ВНУТРИСОСУДИСТОГО И ВНУТРИПУЗЫРНОГО ВВЕДЕНИЯ	Р-Р Д/ВНУТРИСОСУД И ВНУТРИПУЗЫР ВВЕД																							
РАСТВОР ДЛЯ ПОДКОЖНОГО ВВЕДЕНИЯ В КАРТРИДЖ В ШПРИЦ-РУЧКЕ	Р-Р Д/П/К ВВЕД КАРТР В ШПР -РУЧК																							
 ТАБЛЕТКИ ПОКРЫТЫЕ ОБОЛОЧКОЙ ПРОЛОНГИРОВАННОГО ДЕЙСТВИЯ 	 ТАБ П/О ПРОЛОНГ ДЕЙСТВ 																							
ТАБЛЕТКИ ПОКРЫТЫЕ ПЛЕНОЧНОЙ ОБОЛОЧКОЙ КИШЕЧНОРАСТВОРИМЫЕ	ТБЛ П/П/О КИШЕЧНОР.																							
ПОРОШОК ДЛЯ ПРИГОТОВЛЕНИЯ РАСТВОРА ДЛЯ ВНУТРЕННЕГО ПРИЕМА	ПОР. Д/ПРИГОТ. Р-РА Д/ВН. ПРИЁМА.																							
ПОРОШОК ДЛЯ ПРИГОТОВЛЕНИЯ РАСТВОРА ДЛЯ ВНУТРЕННЕГО ПРИЕМА	ПОР. Д/ПРИГОТ. Р-РА Д/ВН. ПРИЁМА.																							
РАСТВОР ДЛЯ ВНУТРИСОСУДИСТОГО И ВНУТРИПОЛОСТНОГО ВВЕДЕНИЯ	Р-Р Д/ ВНУТРИПОЛОСТ И ВНУТРИСОСУД ВВЕД																							
РАСТВОР ДЛЯ ВНУТРИСОСУДИСТОГО И ВНУТРИПОЛОСТНОГО ВВЕДЕНИЯ	Р-Р Д/ВНУТРИПОЛОСТ И ВНУТРИСОСУД ВВЕД																							
РАСТВОР ДЛЯ ВНУТРИСОСУДИСТОГО И ВНУТРИПОЛОСТНОГО ВВЕДЕНИЯ	Р-Р Д/ВНУТРИСОСУД И ВНУТРИПОЛОСТ ВВЕД																							
РАСТВОР ДЛЯ ПРИЕМА ВНУТРЬ И МЕСТНОГО ПРИМЕНЕНИЯ СПИРТОВОЙ	Р-Р Д/ПРИЕМА ВНУТРЬ И МЕСТН ПРИМ СПИРТ																							
РАСТВОР ДЛЯ ПРИЕМА ВНУТРЬ И НАРУЖНОГО ПРИМЕНЕНИЯ МАСЛЯНЫЙ	Р-Р Д/ПРИЕМА ВНУТРЬ И НАРУЖ ПРИМ [МАСЛ]																							
РАСТВОР ДЛЯ ПРИЕМА ВНУТРЬ МЕСТНОГО И НАРУЖНОГО ПРИМЕНЕНИЯ	Р-Р Д/ПРИЕМА ВНУТРЬ МЕСТН И НАРУЖ ПРИМ																							
РАСТВОР ДЛЯ ПРИЕМА ВНУТРЬ МЕСТНОГО И НАРУЖНОГО ПРИМЕНЕНИЯ	Р-Р Д/ПРИЕМА ВНУТРЬ НАРУЖ И МЕСТН ПРИМ																							
СУСПЕНЗИЯ ДЛЯ ВНУТРИМЫШЕЧНОГО И ВНУТРИСУСТАВНОГО ВВЕДЕНИЯ	СУСП Д/ В/М И ВНУТРИСУСТАВ ВВЕД																							
СУСПЕНЗИЯ ДЛЯ ВНУТРИСУСТАВНОГО И ОКОЛОСУСТАВНОГО ВВЕДЕНИЯ	СУСП Д/ ВНУТРИСУСТАВ И ОКОЛОСУСТАВ ВВЕД																							
СУСПЕНЗИЯ ДЛЯ ВНУТРИМЫШЕЧНОГО И ВНУТРИСУСТАВНОГО ВВЕДЕНИЯ	СУСП Д/В/М И В/СУСТАВ ВВЕД																							
СУСПЕНЗИЯ ДЛЯ ВНУТРИМЫШЕЧНОГО И ВНУТРИСУСТАВНОГО ВВЕДЕНИЯ	СУСП Д/В/М И ВНУТРИСУСТ ВВЕД																							
СУСПЕНЗИЯ ДЛЯ ВНУТРИМЫШЕЧНОГО И ВНУТРИСУСТАВНОГО ВВЕДЕНИЯ	СУСП Д/В/М И ВНУТРИСУСТАВ ВВЕД																							
СУСПЕНЗИЯ ДЛЯ ВНУТРИСУСТАВНОГО И ОКОЛОСУСТАВНОГО ВВЕДЕНИЯ	СУСП Д/В/СУСТАВ И О/СУСТАВ ВВЕД																							
СУСПЕНЗИЯ ДЛЯ ВНУТРИСУСТАВНОГО И ОКОЛОСУСТАВНОГО ВВЕДЕНИЯ	СУСП Д/ВНУТРИСУСТАВ/ОКОЛОСУСТАВ ВВЕД																							
 ТАБЛЕТКИ ПОКРЫТЫЕ КИШЕЧНОРАСТВОРИМОЙ САХАРНОЙ ОБОЛОЧКОЙ 	 ТАБ ПОКР КИШЕЧНОР-РИМОЙ САХАР ОБОЛ 																							
КАПСУЛЫ ДЛЯ ПОДКОЖНОГО ВВЕДЕНИЯ ПРОЛОНГИРОВАННОГО ДЕЙСТВИЯ	КАПС Д/ П/К ВВЕД ПРОЛОНГ ДЕЙСТВ																							
КАПСУЛЫ ДЛЯ ПОДКОЖНОГО ВВЕДЕНИЯ ПРОЛОНГИРОВАННОГО ДЕЙСТВИЯ	КАПС Д/П/К ВВЕД ПРОЛОНГ ДЕЙСТВ																							
ПОРОШОК ДЛЯ ПРИГОТОВЛЕНИЯ РАСТВОРА ДЛЯ МЕСТНОГО ПРИМЕНЕНИЯ	ПОР Д/ ПРИГ Р-РА Д/ МЕСТН ПРИМ																							
ПОРОШОК ДЛЯ ПРИГОТОВЛЕНИЯ РАСТВОРА ДЛЯ МЕСТНОГО ПРИМЕНЕНИЯ	ПОР Д/ПРИГ Р-РА Д/МЕСТН ПРИМ																							
ПОРОШОК ДЛЯ ПРИГОТОВЛЕНИЯ РАСТВОРА ДЛЯ ПОДКОЖНОГО ВВЕДЕНИЯ	ПОР Д/ПРИГР-РА Д/П/К ВВЕД																							
ПОРОШОК ДЛЯ ПРИГОТОВЛЕНИЯ СУСПЕНЗИИ ДЛЯ ВНУТРЕННЕГО ПРИЕМА	ПОР. ПРИГОТ. СУСП. Д/ВН. ПРИЕМА																							
 ТАБЛЕТКИ ПОКРЫТЫЕ ПЛЕНОЧНОЙ КИШЕЧНОРАСТВОРИМОЙ ОБОЛОЧКОЙ 	 ТАБ КИШЕЧНОР-РИМЫЕ П/ПЛЕН/О 																							
 ТАБЛЕТКИ ПОКРЫТЫЕ ПЛЕНОЧНОЙ КИШЕЧНОРАСТВОРИМОЙ ОБОЛОЧКОЙ 	 ТАБ КИШЕЧНОР-РИМЫЕ С П/О 																							
 ТАБЛЕТКИ С ЗАМЕДЛЕННЫМ ВЫСВОБОЖДЕНИЕМ ПОКРЫТЫЕ ОБОЛОЧКОЙ 	 ТАБ П/О ЗАМЕД ВЫСВОБОЖД 																							
 ТАБЛЕТКИ С ЗАМЕДЛЕННЫМ ВЫСВОБОЖДЕНИЕМ ПОКРЫТЫЕ ОБОЛОЧКОЙ 	 ТАБ П/О ЗАМЕДЛ ВЫСВОБОЖД 																							
 ТАБЛЕТКИ ПОКРЫТЫЕ ПЛЕНОЧНОЙ КИШЕЧНОРАСТВОРИМОЙ ОБОЛОЧКОЙ 	 ТАБ П/ПЛЕН/О КИШЕЧНОР-РИМОЙ 																							
 ТАБЛЕТКИ ПОКРЫТЫЕ ПЛЕНОЧНОЙ КИШЕЧНОРАСТВОРИМОЙ ОБОЛОЧКОЙ 	 ТАБ ПОКР КИШЕЧНОР-РИМОЙ ПЛЕН ОБОЛ 																							
 ТАБЛЕТКИ ПОКРЫТЫЕ ПЛЕНОЧНОЙ КИШЕЧНОРАСТВОРИМОЙ ОБОЛОЧКОЙ 	 ТАБ ПОКР ПЛЕН К/Р-РИМОЙ ОБОЛ 																							
 ТАБЛЕТКИ ПОКРЫТЫЕ ПЛЕНОЧНОЙ КИШЕЧНОРАСТВОРИМОЙ ОБОЛОЧКОЙ 	 ТАБ ПОКР ПЛЕН КИШЕЧНОР-РИМОЙ ОБОЛ 																							
 ТАБЛЕТКИ С ЗАМЕДЛЕННЫМ ВЫСВОБОЖДЕНИЕМ ПОКРЫТЫЕ ОБОЛОЧКОЙ 	 ТАБ С ЗАМЕДЛ ВЫСВОБОЖД П/О 																							
 ТАБЛЕТКИ С ЗАМЕДЛЕННЫМ ВЫСВОБОЖДЕНИЕМ ПОКРЫТЫЕ ОБОЛОЧКОЙ 	 ТАБ С ЗАМЕДЛЕН ВЫСВОБОЖД П/О 																							
ПОРОШОК ДЛЯ ПРИГОТОВЛЕНИЯ РАСТВОРА ДЛЯ НАРУЖНОГО ПРИМЕНЕНИЯ	ПОР Д/ ПРИГ Р-РА Д/ НАРУЖ ПРИМ																							
ПОРОШОК ДЛЯ ПРИГОТОВЛЕНИЯ РАСТВОРА ДЛЯ НАРУЖНОГО ПРИМЕНЕНИЯ	ПОР Д/ПРИГ Р-РА Д/МЕСТН И НАРУЖ ПРИМ																							
ПОРОШОК ДЛЯ ПРИГОТОВЛЕНИЯ РАСТВОРА ДЛЯ НАРУЖНОГО ПРИМЕНЕНИЯ	ПОР Д/ПРИГ Р-РА Д/НАРУЖ ПРИМ																							
ГРАНУЛЫ ШИПУЧИЕ ДЛЯ ПРИГОТОВЛЕНИЯ РАСТВОРА ДЛЯ ПРИЕМА ВНУТРЬ	ГРАН ШИП Д/ПРИГ Р-РА Д/ПРИЕМА ВНУТРЬ																							
КАПСУЛЫ КИШЕЧНОРАСТВОРИМЫЕ С ПРОЛОНГИРОВАННЫМ ВЫСВОБОЖДЕНИЕМ	КАПС КИШЕЧНОРАСТВ ПРОЛОНГ ДЕЙСТВ																							
КАПСУЛЫ КИШЕЧНОРАСТВОРИМЫЕ С ПРОЛОНГИРОВАННЫМ ВЫСВОБОЖДЕНИЕМ	КАПС КИШЕЧНОРАСТВ С ПРОЛОНГ ВЫСВОБОЖД																							
ПОРОШОК ДЛЯ ПРИГОТОВЛЕНИЯ СУСПЕНЗИИ ДЛЯ НАРУЖНОГО ПРИМЕНЕНИЯ	ПОР Д/ПРИГ СУСП Д/НАРУЖ ПРИМ																							
ПОРОШОК ШИПУЧИЙ ДЛЯ ПРИГОТОВЛЕНИЯ РАСТВОРА ДЛЯ ПРИЕМА ВНУТРЬ	ПОР ШИП Д/ПРИГ Р-РА Д/ПРИЕМА ВНУТРЬ																							
 АПТЕКАРЬ ШЕЛЛЕР  (APOTHEKER SCHELLER) (APOTHEKER SCHELLER)  	 APOTHEKER SCHELLER  																							
ЛИОФИЛИЗАТ ДЛЯ ПРИГОТОВЛЕНИЯ РАСТВОРА ДЛЯ МЕСТНОГО ПРИМЕНЕНИЯ	ЛИОФ-Т Д/ ПРИГ Р-РА Д/ МЕСТН ПРИМ																							
ЛИОФИЛИЗАТ ДЛЯ ПРИГОТОВЛЕНИЯ РАСТВОРА ДЛЯ ПОДКОЖНОГО ВВЕДЕНИЯ	ЛИОФ-Т Д/ ПРИГ Р-РА Д/ П/К ВВЕД																							
ЛИОФИЛИЗАТ ДЛЯ ПРИГОТОВЛЕНИЯ РАСТВОРА ДЛЯ МЕСТНОГО ПРИМЕНЕНИЯ	ЛИОФ-Т Д/ПРИГ Р-РА Д/ МЕСТН ПРИМ																							
ЛИОФИЛИЗАТ ДЛЯ ПРИГОТОВЛЕНИЯ РАСТВОРА ДЛЯ ПОДКОЖНОГО ВВЕДЕНИЯ	ЛИОФ-Т Д/ПРИГ Р-РА Д/ П/К ВВЕД																							
ЛИОФИЛИЗАТ ДЛЯ ПРИГОТОВЛЕНИЯ РАСТВОРА ДЛЯ МЕСТНОГО ПРИМЕНЕНИЯ	ЛИОФ-Т Д/ПРИГ-Я Р-РА Д/МЕСТН ПРИМ																							
ЛИОФИЛИЗАТ ДЛЯ ПРИГОТОВЛЕНИЯ РАСТВОРА ДЛЯ ПОДКОЖНОГО ВВЕДЕНИЯ	ЛИОФ-Т Д/ПРИГ-Я Р-РА Д/П/К ВВЕД																							
ЛИОФИЛИЗАТ ДЛЯ ПРИГОТОВЛЕНИЯ РАСТВОРА ДЛЯ МЕСТНОГО ПРИМЕНЕНИЯ	ЛИОФИЛ Д/ ПРИГ Р-РА Д/ МЕСТН ПРИМ																							
ЛИОФИЛИЗАТ ДЛЯ ПРИГОТОВЛЕНИЯ РАСТВОРА ДЛЯ ПОДКОЖНОГО ВВЕДЕНИЯ	ЛИОФИЛ Д/ ПРИГ Р-РА Д/ П/К ВВЕД																							
ЛИОФИЛИЗАТ ДЛЯ ПРИГОТОВЛЕНИЯ РАСТВОРА ДЛЯ МЕСТНОГО ПРИМЕНЕНИЯ	ЛИОФИЛ Д/ПРИГ Р-РА Д/МЕСТН ПРИМ																							
ЛИОФИЛИЗАТ ДЛЯ ПРИГОТОВЛЕНИЯ РАСТВОРА ДЛЯ ПОДКОЖНОГО ИНЪЕКЦИЙ	ЛИОФИЛ Д/ПРИГ Р-РА Д/П/К ВВЕД																							
ПОРОШОК ДЛЯ ПРИГОТОВЛЕНИЯ РАСТВОРА ДЛЯ ВНУТРИВЕННОГО ВВЕДЕНИЯ	ПОР Д/ ПРИГ Р-РА Д/ В/В ВВЕД																							
ПОРОШОК ДЛЯ ПРИГОТОВЛЕНИЯ РАСТВОРА ДЛЯ ВНУТРИВЕННОГО ВВЕДЕНИЯ	ПОР Д/ПРИГ Р-РА Д/В/В ВВЕД																							
ПОРОШОК ДЛЯ ПРИГОТОВЛЕНИЯ РАСТВОРА ДЛЯ ВНУТРИВЕННОГО ВВЕДЕНИЯ	ПОР Д/Р-РА В/В																							
 ТАБЛЕТКИ ДЛЯ ПРИГОТОВЛЕНИЯ РАСТВОРА ДЛЯ МЕСТНОГО ПРИМЕНЕНИЯ 	 ТАБ Д/ПРИГ Р-РА Д/МЕСТН ПРИМ 																							
 ТАБЛЕТКИ С КОНТРОЛИРУЕМЫМ ВЫСВОБОЖДЕНИЕМ ПОКРЫТЫЕ ОБОЛОЧКОЙ 	 ТАБ П/О КОНТРОЛ ВЫСВОБОЖД 																							
 ТАБЛЕТКИ С КОНТРОЛИРУЕМЫМ ВЫСВОБОЖДЕНИЕМ ПОКРЫТЫЕ ОБОЛОЧКОЙ 	 ТАБ П/О С КОНТРОЛ ВЫСВОБ 																							
 ТАБЛЕТКИ С КОНТРОЛИРУЕМЫМ ВЫСВОБОЖДЕНИЕМ ПОКРЫТЫЕ ОБОЛОЧКОЙ 	 ТАБ П/О С КОНТРОЛ ВЫСВОБОЖД 																							
ТАБЛЕТКИ ПОКРЫТЫЕ ОБОЛОЧКОЙ С МОДИФИЦИРОВАННЫМ ВЫСВОБОЖДЕНИЕМ	ТАБ.П/О С МОД.ВЫСВ.																							
ГРАНУЛЫ ДЛЯ ПРИГОТОВЛЕНИЯ РАСТВОРА ДЛЯ ПРИЕМА ВНУТРЬ ДЛЯ ДЕТЕЙ	ГРАН Д/ПРИГ Р-РА Д/ПРИЕМА ВНУТРЬ Д/ДЕТ																							
ГРАНУЛЫ ДЛЯ ПРИГОТОВЛЕНИЯ РАСТВОРА ДЛЯ ПРИЕМА ВНУТРЬ ДЛЯ ДЕТЕЙ	ГРАН Д/ПРИГ Р-РА ДЕТ																							
КОНЦЕНТРАТ ДЛЯ ПРИГОТОВЛЕНИЯ РАСТВОРА ДЛЯ НАРУЖНОГО ПРИМЕНЕНИЯ	КОНЦ Д/ПРИГ Р-РА Д/НАРУЖ ПРИМ																							
ЛИОФИЛИЗАТ ДЛЯ ПРИГОТОВЛЕНИЯ СУСПЕНЗИИ ДЛЯ ПОДКОЖНОГО ВВЕДЕНИЯ	ЛИОФ-Т Д/ ПРИГ СУСП Д/ П/К ВВЕД																							
ЛИОФИЛИЗАТ ДЛЯ ПРИГОТОВЛЕНИЯ СУСПЕНЗИИ ДЛЯ ПОДКОЖНОГО ВВЕДЕНИЯ	ЛИОФ-Т Д/ПРИГ СУСП Д/ П/К ВВЕД																							
ЛИОФИЛИЗАТ ДЛЯ ПРИГОТОВЛЕНИЯ СУСПЕНЗИИ ДЛЯ ПОДКОЖНОГО ВВЕДЕНИЯ	ЛИОФ-Т Д/ПРИГ-Я СУСП Д/П/КН ВВЕД																							
ЛИОФИЛИЗАТ ДЛЯ ПРИГОТОВЛЕНИЯ СУСПЕНЗИИ ДЛЯ ПОДКОЖНОГО ВВЕДЕНИЯ	ЛИОФИЛ Д/ ПРИГ СУСП Д/ П/К ВВЕД																							
ЛИОФИЛИЗАТ ДЛЯ ПРИГОТОВЛЕНИЯ РАСТВОРА ДЛЯ ИНЪЕКЦИЙ И ИНГАЛЯЦИЙ	ЛИОФИЛ Д/ПРИГ Р-РА Д/ИН И ИНГ																							
ЛИОФИЛИЗАТ ДЛЯ ПРИГОТОВЛЕНИЯ РАСТВОРА ДЛЯ НАРУЖНОГО ПРИМЕНЕНИЯ	ЛИОФИЛ Д/ПРИГ Р-РА Д/НАРУЖ ПРИМ																							
ЛИОФИЛИЗАТ ДЛЯ ПРИГОТОВЛЕНИЯ СУСПЕНЗИИ ДЛЯ ПОДКОЖНОГО ВВЕДЕНИЯ	ЛИОФИЛ Д/ПРИГ СУСПД/П/К ВВЕД																							
ПОРОШОК ДЛЯ ПРИГОТОВЛЕНИЯ РАСТВОРА ДЛЯ ПРИЕМА ВНУТРЬ ДЛЯ ДЕТЕЙ	ПОР Д/ ПРИГ Р-РА Д/ ПРИЕМА ВНУТРЬ Д/ ДЕТ																							
ПОРОШОК ДЛЯ ПРИГОТОВЛЕНИЯ РАСТВОРА ДЛЯ ПРИЕМА ВНУТРЬ ДЛЯ ДЕТЕЙ	ПОР Д/ПРИГ Р-РА Д/ПРИЕМА ВНУТРЬ Д/ДЕТ																							
РАСТВОРИТЕЛЬ ДЛЯ ПРИГОТОВЛЕНИЯ ЛЕКАРСТВЕННЫХ ФОРМ ДЛЯ ИНЪЕКЦИЙ	Р-ТЕЛЬ Д/ПРИГ ЛЕК ФОРМ Д/И																							
ГРАНУЛЫ ПОКРЫТЫЕ КИШЕЧНОРАСТВОРИМОЙ ОБОЛОЧКОЙ ДЛЯ ПРИЕМА ВНУТРЬ	ГРАН КИШЕЧНОРАСТВ П/О Д/ПРИЕМА ВНУТРЬ																							
ГРАНУЛЫ ПОКРЫТЫЕ ПЛЕНОЧНОЙ ОБОЛОЧКОЙ ПРОЛОНГИРОВАННОГО ДЕЙСТВИЯ	ГРАН П/П/О ПРОЛОНГ Д-Я																							
ГРАНУЛЫ ПОКРЫТЫЕ КИШЕЧНОРАСТВОРИМОЙ ОБОЛОЧКОЙ ДЛЯ ПРИЕМА ВНУТРЬ	ГРАН ПОКР КИШЕЧНОР-РИМОЙ ОБОЛ Д/ПРИЕМА ВНУТРЬ																							
ПОРОШОК ДЛЯ ПРИГОТОВЛЕНИЯ РАСТВОРА ДЛЯ ВНУТРИМЫШЕЧНОГО ВВЕДЕНИЯ	ПОР Д/ ПРИГ Р-РА Д/ В/М ВВЕД																							
ПОРОШОК ДЛЯ ПРИГОТОВЛЕНИЯ РАСТВОРА ДЛЯ ВНУТРИМЫШЕЧНОГО ВВЕДЕНИЯ	ПОР Д/ПРИГ Р-РА Д/В/М ВВЕД																							
 ТАБЛЕТКИ С МОДИФИЦИРОВАННЫМ ВЫСВОБОЖДЕНИЕМ ПОКРЫТЫЕ ОБОЛОЧКОЙ 	 ТАБ П/О С МОДИФИЦ ВЫСВОБ 																							
 ТАБЛЕТКИ С МОДИФИЦИРОВАННЫМ ВЫСВОБОЖДЕНИЕМ ПОКРЫТЫЕ ОБОЛОЧКОЙ 	 ТАБ П/О С МОДИФИЦ ВЫСВОБОЖД 																							
 ТАБЛЕТКИ С МОДИФИЦИРОВАННЫМ ВЫСВОБОЖДЕНИЕМ ПОКРЫТЫЕ ОБОЛОЧКОЙ 	 ТАБ С МОДИФИЦ ВЫСВОБОЖД П/О 																							
 ТАБЛЕТКИ С МОДИФИЦИРОВАННЫМ ВЫСВОБОЖДЕНИЕМ ПОКРЫТЫЕ ОБОЛОЧКОЙ 	 ТАБ С МОДИФИЦИР ВЫСВОБОЖД П/О 																							
КОНЦЕНТРАТ ДЛЯ ПРИГОТОВЛЕНИЯ РАСТВОРА ДЛЯ ВНУТРИВЕННОГО ВВЕДЕНИЯ	КОНЦ Д/ПРИГ Р-РА Д/ В/В ВВЕД (АМПУЛЫ)																							
КОНЦЕНТРАТ ДЛЯ ПРИГОТОВЛЕНИЯ РАСТВОРА ДЛЯ ВНУТРИВЕННОГО ВВЕДЕНИЯ	КОНЦ Д/ПРИГ Р-РА Д/В/В ВВЕД																							
КОНЦЕНТРИРОВАННЫЙ РАСТВОР ДЛЯ ПРИГОТОВЛЕНИЯ РАСТВОРА ДЛЯ ИНФУЗИЙ	КОНЦ Д/ПРИГ Р-РА Д/ИНФ																							
КОНЦЕНТРИРОВАННЫЙ РАСТВОР ДЛЯ ПРИГОТОВЛЕНИЯ РАСТВОРА ДЛЯ ИНФУЗИЙ	КОНЦ Р-Р Д/ПРИГ Р-РА Д/ИНФ																							
ЛИОФИЛИЗАТ ДЛЯ ПРИГОТОВЛЕНИЯ РАСТВОРА ДЛЯ ВНУТРИВЕННОГО ВВЕДЕНИЯ	ЛИОФ-Т Д/ ПРИГ Р-РА Д/ В/В ВВЕДЕНИ																							
ЛИОФИЛИЗАТ ДЛЯ ПРИГОТОВЛЕНИЯ РАСТВОРА ДЛЯ ВНУТРИВЕННОГО ВВЕДЕНИЯ	ЛИОФ-Т Д/ПРИГ Р-РА Д/ В/В ВВЕД																							
ЛИОФИЛИЗАТ ДЛЯ ПРИГОТОВЛЕНИЯ РАСТВОРА ДЛЯ ВНУТРИВЕННОГО ВВЕДЕНИЯ	ЛИОФ-Т Д/ПРИГ-Я Р-РА Д/ В/В ВВЕД																							
ЛИОФИЛИЗАТ ДЛЯ ПРИГОТОВЛЕНИЯ РАСТВОРА ДЛЯ ВНУТРИВЕННОГО ВВЕДЕНИЯ	ЛИОФ-Т Д/ПРИГ-Я Р-РА Д/В/В ВВЕД																							
лиофилизат для приготовления раствора для внутривенного введения	ЛИОФ.Д/Р-РА ДЛЯ В/В ВВЕД.																							
ЛИОФИЛИЗАТ ДЛЯ ПРИГОТОВЛЕНИЯ РАСТВОРА ДЛЯ ВНУТРИВЕННОГО ВВЕДЕНИЯ	ЛИОФИЛ Д/ ПРИГ Р-РА Д/ В/В ВВЕДЕНИ																							
ЛИОФИЛИЗАТ ДЛЯ ПРИГОТОВЛЕНИЯ РАСТВОРА ДЛЯ ВНУТРИВЕННОГО ВВЕДЕНИЯ	ЛИОФИЛ Д/ПРИГ Р-РА Д/В/В ВВЕД																							
ЛИОФИЛИЗАТ ДЛЯ ПРИГОТОВЛЕНИЯ РАСТВОРА ДЛЯ ВНУТРИКОЖНОГО ВВЕДЕНИЯ	ЛИОФИЛ Д/ПРИГ Р-РА Д/В/К ВВЕД																							
ЛИОФИЛИЗИРОВАННЫЙ ПОРОШОК ДЛЯ ПРИГОТОВЛЕНИЯ РАСТВОРА ДЛЯ ИНФУЗИЙ	ЛИОФИЛ ПОР Д/ПРИГ Р-РА Д/ИНФ																							
ПОРОШОК ДЛЯ ПРИГОТОВЛЕНИЯ СУСПЕНЗИИ ДЛЯ ВНУТРИМЫШЕЧНОГО ВВЕДЕНИЯ	ПОР Д/ ПРИГ СУСП Д/ В/М ВВЕД																							
ПОРОШОК ДЛЯ ПРИГОТОВЛЕНИЯ РАСТВОРА ДЛЯ ПРИЕМА ВНУТРЬ (ДЛЯ ДЕТЕЙ)	ПОР Д/ПРИГ Р-РА Д/ПРИЕМА ВНУТРЬ Д/ ДЕТ																							
ПОРОШОК ДЛЯ ПРИГОТОВЛЕНИЯ СУСПЕНЗИИ ДЛЯ ВНУТРИМЫШЕЧНОГО ВВЕДЕНИЯ	ПОР Д/ПРИГ СУСП В/М																							
ПОРОШОК ДЛЯ ПРИГОТОВЛЕНИЯ СУСПЕНЗИИ ДЛЯ ВНУТРИМЫШЕЧНОГО ВВЕДЕНИЯ	ПОР Д/ПРИГ СУСП Д/В/М ВВЕД																							
ЛИОФИЛИЗАТ ДЛЯ ПРИГОТОВЛЕНИЯ СУСПЕНЗИИ ДЛЯ ВНУТРИКОЖНОГО ВВЕДЕНИЯ	ЛИОФ-Т Д/ ПРИГ СУСП Д/ ВНУТРИКОЖ ВВЕД																							
ЛИОФИЛИЗАТ ДЛЯ ПРИГОТОВЛЕНИЯ СУСПЕНЗИИ ДЛЯ ВНУТРИКОЖНОГО ВВЕДЕНИЯ	ЛИОФ-Т Д/ПРИГ СУСП Д/ ВНУТРИКОЖ ВВЕД																							
ЛИОФИЛИЗАТ ДЛЯ ПРИГОТОВЛЕНИЯ СУСПЕНЗИИ ДЛЯ ВНУТРИКОЖНОГО ВВЕДЕНИЯ	ЛИОФ-Т Д/ПРИГ-Я СУСП Д/ВНУТРИКОЖ ВВЕД																							
ЛИОФИЛИЗАТ ДЛЯ ПРИГОТОВЛЕНИЯ СУСПЕНЗИИ ДЛЯ ВНУТРИКОЖНОГО ВВЕДЕНИЯ	ЛИОФИЛ Д/ ПРИГ СУСП Д/ ВНУТРИКОЖ ВВЕД																							
ЛИОФИЛИЗАТ ДЛЯ ПРИГОТОВЛЕНИЯ СУСПЕНЗИИ ДЛЯ ВНУТРИКОЖНОГО ВВЕДЕНИЯ	ЛИОФИЛ Д/ПРИГ СУСПД/ВНУТРИКОЖ ВВЕД																							
ЛИОФИЛИЗАТ ДЛЯ ПРИГОТОВЛЕНИЯ ЭМУЛЬСИИ ДЛЯ ИНГАЛЯЦИОННОГО ВВЕДЕНИЯ	ЛИОФИЛ Д/ПРИГ ЭМУЛЬС Д/ИНГ ВВЕД																							
ЛИОФИЛИЗИРОВАННЫЙ ПОРОШОК ДЛЯ ПРИГОТОВЛЕНИЯ РАСТВОРА ДЛЯ ИНЪЕКЦИЙ	ЛИОФИЛ ПОР Д/ПРИГ Р-РА Д/ИН																							
РАСТВОР ДЛЯ ВНУТРИМЫШЕЧНОГО И ПОДКОЖНОГО ВВЕДЕНИЯ ГОМЕОПАТИЧЕСКИЙ	Р-Р Д/ В/М И П/К ВВЕД ГОМЕОПАТ																							
РАСТВОР ДЛЯ ПРИЕМА ВНУТРЬ И ИНГАЛЯЦИЙ В КОМПЛЕКТЕ С РАСТВОРИТЕЛЕМ	Р-Р Д/ПРИЕМА ВНУТРЬ И ИНГ В КОМПЛЕК С РАС-ЛЕМ																							
СУСПЕНЗИЯ ДЛЯ ВНУТРИМЫШЕЧНОГО ВВЕДЕНИЯ ПРОЛОНГИРОВАННОГО ДЕЙСТВИЯ	СУСП Д/ В/М ВВЕД ПРОЛОНГ ДЕЙСТВ																							
СУСПЕНЗИЯ ДЛЯ ВНУТРИМЫШЕЧНОГО ВВЕДЕНИЯ ПРОЛОНГИРОВАННОГО ДЕЙСТВИЯ	СУСП Д/В/М ВВЕД ПРОЛОНГ																							
СУСПЕНЗИЯ ДЛЯ ВНУТРИМЫШЕЧНОГО ВВЕДЕНИЯ ПРОЛОНГИРОВАННОГО ДЕЙСТВИЯ	СУСП Д/В/М ВВЕД ПРОЛОНГ ДЕЙСТВ																							
КОНЦЕНТРАТ ДЛЯ ПРИГОТОВЛЕНИЯ РАСТВОРА ДЛЯ ВНУТРИМЫШЕЧНОГО ВВЕДЕНИЯ	КОНЦ Д/ПРИГ Р-РА Д/ В/М ВВЕД																							
КОНЦЕНТРАТ ДЛЯ ПРИГОТОВЛЕНИЯ РАСТВОРА ДЛЯ ВНУТРИМЫШЕЧНОГО ВВЕДЕНИЯ	КОНЦ Д/ПРИГ Р-РА Д/В/М ВВЕД																							
ЛИОФИЛИЗАТ ДЛЯ ПРИГОТОВЛЕНИЯ РАСТВОРА ДЛЯ ВНУТРИМЫШЕЧНОГО ВВЕДЕНИЯ	ЛИОФ-Т Д/ ПРИГ Р-РА Д/ В/М ВВЕД																							
ЛИОФИЛИЗАТ ДЛЯ ПРИГОТОВЛЕНИЯ РАСТВОРА ДЛЯ ИНТРАНАЗАЛЬНОГО ВВЕДЕНИЯ	ЛИОФ-Т Д/ ПРИГ Р-РА Д/ ИНТРАНАЗ ВВЕД																							
ЛИОФИЛИЗАТ ДЛЯ ПРИГОТОВЛЕНИЯ РАСТВОРА ДЛЯ ВНУТРИМЫШЕЧНОГО ВВЕДЕНИЯ	ЛИОФ-Т Д/ПРИГ Р-РА Д/ В/М ВВЕД																							
ЛИОФИЛИЗАТ ДЛЯ ПРИГОТОВЛЕНИЯ РАСТВОРА ДЛЯ ИНТРАНАЗАЛЬНОГО ВВЕДЕНИЯ	ЛИОФ-Т Д/ПРИГ Р-РА Д/ ИНТРАНАЗ ВВЕД																							
ЛИОФИЛИЗАТ ДЛЯ ПРИГОТОВЛЕНИЯ РАСТВОРА ДЛЯ ВНУТРИМЫШЕЧНОГО ВВЕДЕНИЯ	ЛИОФ-Т Д/ПРИГ-Я Р-РА Д/ В/М ВВЕД																							
ЛИОФИЛИЗАТ ДЛЯ ПРИГОТОВЛЕНИЯ РАСТВОРА ДЛЯ ИНТРАНАЗАЛЬНОГО ВВЕДЕНИЯ	ЛИОФ-Т Д/ПРИГ-Я Р-РА Д/ ИНТРАНАЗ ВВЕД																							
ЛИОФИЛИЗАТ ДЛЯ ПРИГОТОВЛЕНИЯ РАСТВОРА ДЛЯ ВНУТРИМЫШЕЧНОГО ВВЕДЕНИЯ	ЛИОФ-Т Д/ПРИГ-Я Р-РА Д/В/М ВВЕД																							
ЛИОФИЛИЗАТ ДЛЯ ПРИГОТОВЛЕНИЯ РАСТВОРА ДЛЯ ИНТРАНАЗАЛЬНОГО ВВЕДЕНИЯ	ЛИОФ-Т Д/ПРИГ-Я Р-РА Д/ИНТРАНАЗ ВВЕД																							
ЛИОФИЛИЗАТ ДЛЯ ПРИГОТОВЛЕНИЯ РАСТВОРА ДЛЯ ВНУТРИМЫШЕЧНОГО ВВЕДЕНИЯ	ЛИОФИЛ Д/ ПРИГ Р-РА Д/ В/М ВВЕД																							
ЛИОФИЛИЗАТ ДЛЯ ПРИГОТОВЛЕНИЯ РАСТВОРА ДЛЯ ИНТРАНАЗАЛЬНОГО ВВЕДЕНИЯ	ЛИОФИЛ Д/ ПРИГ Р-РА Д/ ИНТРАНАЗ ВВЕД																							
ЛИОФИЛИЗАТ ДЛЯ ПРИГОТОВЛЕНИЯ РАСТВОРА ДЛЯ ВНУТРИМЫШЕЧНОГО ВВЕДЕНИЯ	ЛИОФИЛ Д/ПРИГ Р-РА Д/ В/М ВВЕД																							
ЛИОФИЛИЗАТ ДЛЯ ПРИГОТОВЛЕНИЯ РАСТВОРА ДЛЯ ВНУТРИМЫШЕЧНОГО ВВЕДЕНИЯ	ЛИОФИЛ Д/ПРИГ Р-РА Д/ В/М ВВЕД С Р-ЛЕМ ФЛ																							
ЛИОФИЛИЗАТ ДЛЯ ПРИГОТОВЛЕНИЯ РАСТВОРА ДЛЯ ВНУТРИМЫШЕЧНОГО ВВЕДЕНИЯ	ЛИОФИЛ Д/ПРИГ Р-РА Д/В/М ВВЕД																							
ЛИОФИЛИЗАТ ДЛЯ ПРИГОТОВЛЕНИЯ РАСТВОРА ДЛЯ ИНТРАНАЗАЛЬНОГО ВВЕДЕНИЯ	ЛИОФИЛ Д/ПРИГ Р-РА Д/ИНТРАНАЗ ВВЕД																							
ПОРОШОК ДЛЯ ПРИГОТОВЛЕНИЯ РАСТВОРА ДЛЯ ПРИЕМА ВНУТРЬ И ИНСТИЛЛЯЦИЙ	ПОР (САШЕ) Д/ПРИГ Р-РА Д/ПРИЕМА ВНУТРЬ																							
ПОРОШОК ДЛЯ ПРИГОТОВЛЕНИЯ РАСТВОРА ДЛЯ ИНЪЕКЦИЙ +ВОДА ДЛЯ ИНЪЕКЦИЙ	ПОР Д/ ПРИГ Р-РА Д/ ИН +ВОДА Д/ ИН																							
ПОРОШОК ДЛЯ ПРИГОТОВЛЕНИЯ РАСТВОРА ДЛЯ ПРИЕМА ВНУТРЬ И ИНСТИЛЛЯЦИЙ	ПОР Д/ПРИГ Р-РА Д/ПРИЕМА ВНУТРЬ И ИНСТИЛ																							
РАСТВОР ДЛЯ ВНУТРИВЕННОГО ВВЕДЕНИЯ МЕСТНОГО И НАРУЖНОГО ПРИМЕНЕНИЯ	Р-Р Д/ В/В ВВЕД МЕСТН И НАРУЖ ПРИМ																							
 ТАБЛЕТКИ ПОКРЫТЫЕ ПЛЕНОЧНОЙ ОБОЛОЧКОЙ ЗАМЕДЛЕННОГО ВЫСВОБОЖДЕНИЯ 	 ТАБ П/ПЛЕН/О ЗАМЕДЛ ВЫСВОБОЖД 																							
 ТАБЛЕТКИ ПОКРЫТЫЕ ПЛЕНОЧНОЙ ОБОЛОЧКОЙ ПРОЛОНГИРОВАННОГО ДЕЙСТВИЯ 	 ТАБ П/ПЛЕН/О С ПРОЛОНГ ВЫСВОБОЖ 																							
 ТАБЛЕТКИ ПОКРЫТЫЕ ПЛЕНОЧНОЙ ОБОЛОЧКОЙ ПРОЛОНГИРОВАННОГО ДЕЙСТВИЯ 	 ТАБ П/ПЛЕН/О С ПРОЛОНГ ВЫСВОБОЖД 																							
 ТАБЛЕТКИ ПОКРЫТЫЕ ПЛЕНОЧНОЙ ОБОЛОЧКОЙ ПРОЛОНГИРОВАННОГО ДЕЙСТВИЯ 	 ТАБ ПРОЛОНГ ДЕЙСТВ П/ПЛЕН/О 																							
ЛИОФИЛИЗАТ ДЛЯ ПРИГОТОВЛЕНИЯ СУСПЕНЗИИ ДЛЯ ВНУТРИПУЗЫРНОГО ВВЕДЕНИЯ	ЛИОФ-Т Д/ ПРИГ СУСП Д/ ВНУТРИПУЗЫРНОГО ВВЕД																							
ЛИОФИЛИЗАТ ДЛЯ ПРИГОТОВЛЕНИЯ СУСПЕНЗИИ ДЛЯ ВНУТРИПУЗЫРНОГО ВВЕДЕНИЯ	ЛИОФ-Т Д/ПРИГ СУСП Д/ ВНУТРИПУЗЫРНОГО ВВЕД																							
ЛИОФИЛИЗАТ ДЛЯ ПРИГОТОВЛЕНИЯ СУСПЕНЗИИ ДЛЯ ВНУТРИПУЗЫРНОГО ВВЕДЕНИЯ	ЛИОФ-Т Д/ПРИГ-Я СУСП Д/ВНУТРИПУЗЫРНОГО ВВЕД																							
ЛИОФИЛИЗАТ ДЛЯ ПРИГОТОВЛЕНИЯ СУСПЕНЗИИ ДЛЯ ВНУТРИПУЗЫРНОГО ВВЕДЕНИЯ	ЛИОФИЛ Д/ ПРИГ СУСП Д/ ВНУТРИПУЗЫРНОГО ВВЕД																							
ЛИОФИЛИЗАТ ДЛЯ ПРИГОТОВЛЕНИЯ СУСПЕНЗИИ ДЛЯ ВНУТРИПУЗЫРНОГО ВВЕДЕНИЯ	ЛИОФИЛ Д/ПРИГ СУСП Д/ВНУТРИПУЗЫРНОГО ВВЕД																							
ЛИОФИЛИЗАТ ДЛЯ ПРИГОТОВЛЕНИЯ СУСПЕНЗИИ ДЛЯ ВНУТРИМЫШЕЧНОГО ВВЕДЕНИЯ	ЛИОФИЛ Д/ПРИГ СУСПД/В/М ВВЕД																							
МИКРОСФЕРЫ ДЛЯ ПРИГОТОВЛЕНИЯ СУСПЕНЗИИ ДЛЯ ВНУТРИМЫШЕЧНОГО ВВЕДЕНИЯ	МК/СФЕРЫ Д/ПРИГ СУСП Д/В/В/М ВВЕД																							
МИКРОСФЕРЫ ДЛЯ ПРИГОТОВЛЕНИЯ СУСПЕНЗИИ ДЛЯ ВНУТРИМЫШЕЧНОГО ВВЕДЕНИЯ	МК/СФЕРЫ Д/ПРИГ СУСП Д/В/М ВВЕД																							
МИКРОСФЕРЫ ДЛЯ ПРИГОТОВЛЕНИЯ СУСПЕНЗИИ ДЛЯ ВНУТРИМЫШЕЧНОГО ВВЕДЕНИЯ	МК/СФЕРЫ Д/ПРИГ СУСП Д/В/М ВВЕД (ФЛ)																							
ПОРОШОК ДЛЯ ПРИГОТОВЛЕНИЯ РАСТВОРА ДЛЯ ИНЪЕКЦИЙ + ВОДА ДЛЯ ИНЪЕКЦИЙ	ПОР Д/ПРИГ Р-РА Д/ИНЪЕКЦ+ВОДА Д/ИНЪЕКЦ																							
РАСТВОР ДЛЯ НАРУЖНОГО ПРИМЕНЕНИЯ И ПРИГОТОВЛЕНИЯ ЛЕКАРСТВЕННЫХ ФОРМ	Р-Р Д/НАРУЖ ПРИМ И ПРИГ ЛЕК ФОРМ																							
РАСТВОР ДЛЯ ПРИЕМА ВНУТРЬ МЕСТНОГО И НАРУЖНОГО ПРИМЕНЕНИЯ СПИРТОВОЙ	Р-Р Д/ПРИЕМА ВНУТРЬ И МЕСТН ПРИМ [СПИРТ]																							
ЛИОФИЛИЗАТ ДЛЯ ПРИГОТОВЛЕНИЯ СУСПЕНЗИИ ДЛЯ ЭНДОТРАХЕАЛЬНОГО ВВЕДЕНИЯ	ЛИОФ-Т Д/ ПРИГ СУСП Д/ ЭНДОТРАХЕАЛЬНОГО ВВЕД																							
ЛИОФИЛИЗАТ ДЛЯ ПРИГОТОВЛЕНИЯ СУСПЕНЗИИ ДЛЯ ЭНДОТРАХЕАЛЬНОГО ВВЕДЕНИЯ	ЛИОФ-Т Д/ПРИГ СУСП Д/ ЭНДОТРАХЕАЛЬНОГО ВВЕД																							
ЛИОФИЛИЗАТ ДЛЯ ПРИГОТОВЛЕНИЯ СУСПЕНЗИИ ДЛЯ ЭНДОТРАХЕАЛЬНОГО ВВЕДЕНИЯ	ЛИОФ-Т Д/ПРИГ-Я СУСП Д/ЭНДОТРАХЕАЛЬНОГО ВВЕД																							
ЛИОФИЛИЗАТ ДЛЯ ПРИГОТОВЛЕНИЯ СУСПЕНЗИИ ДЛЯ ЭНДОТРАХЕАЛЬНОГО ВВЕДЕНИЯ	ЛИОФИЛ Д/ ПРИГ СУСП Д/ ЭНДОТРАХЕАЛЬНОГО ВВЕД																							
ЛИОФИЛИЗАТ ДЛЯ ПРИГОТОВЛЕНИЯ РАСТВОРА ДЛЯ ВНУТРИСОСУДИСТОГО ВВЕДЕНИЯ	ЛИОФИЛ Д/ПРИГ Р-РА Д/ВНУТРИСОСУД ВВЕД																							
РАСТВОР ДЛЯ ВНУТРИВЕННОГО ВНУТРИМЫШЕЧНОГО И ПАРАБУЛЬБАРНОГО ВВЕДЕНИЯ	Р-Р Д/ В/В В/М И ПАРАБУЛЬБАР ВВЕД																							
РАСТВОР ДЛЯ ВНУТРИВЕННОГО ВНУТРИМЫШЕЧНОГО И ПАРАБУЛЬБАРНОГО ВВЕДЕНИЯ	Р-Р Д/ В/В И ПАРАБУЛЬБАР ВВЕД																							
РАСТВОР ДЛЯ ВНУТРИВЕННОГО ВНУТРИМЫШЕЧНОГО И ПАРАБУЛЬБАРНОГО ВВЕДЕНИЯ	Р-Р Д/В/В В/М И ПАРАБУЛЬБАР ВВЕД																							
БИНТ МЕДИЦИНСКИЙ ЭЛАСТИЧНЫЙ ТРУБЧАТЫЙ Д/ФИКСАЦИИ КОЛЕННОГО СУСТАВА №3	БИНТ МЕД ЭЛАСТ ТРУБЧ Д/ФИКС КОЛЕН СУСТ №3																							
БИНТ МЕДИЦИНСКИЙ ЭЛАСТИЧНЫЙ ТРУБЧАТЫЙ Д/ФИКСАЦИИ КОЛЕННОГО СУСТАВА №4	БИНТ МЕД ЭЛАСТ ТРУБЧ Д/ФИКС КОЛЕН СУСТ №4																							
БИНТ МЕДИЦИНСКИЙ ЭЛАСТИЧНЫЙ ТРУБЧАТЫЙ Д/ФИКСАЦИИ ЛОКТЕВОГО СУСТАВА №1	БИНТ МЕД ЭЛАСТ ТРУБЧ Д/ФИКС ЛОКТЕВ СУСТ №1																							
БИНТ МЕДИЦИНСКИЙ ЭЛАСТИЧНЫЙ ТРУБЧАТЫЙ Д/ФИКСАЦИИ ЛОКТЕВОГО СУСТАВА №2	БИНТ МЕД ЭЛАСТ ТРУБЧ Д/ФИКС ЛОКТЕВ СУСТ №2																							
БИНТ МЕДИЦИНСКИЙ ЭЛАСТИЧНЫЙ ТРУБЧАТЫЙ Д/ФИКСАЦИИ ЛОКТЕВОГО СУСТАВА №3	БИНТ МЕД ЭЛАСТ ТРУБЧ Д/ФИКС ЛОКТЕВ СУСТ №3																							
ЛИОФИЛИЗАТ ДЛЯ ПРИГОТОВЛЕНИЯ РАСТВОРА ДЛЯ ВНУТРИКАВЕРНОЗНОГО ВВЕДЕНИЯ	ЛИОФ-Т Д/ ПРИГ Р-РА Д/ ВНУТРИКАВЕРНОЗНОГО ВВЕД																							
ЛИОФИЛИЗАТ ДЛЯ ПРИГОТОВЛЕНИЯ РАСТВОРА ДЛЯ ВНУТРИКАВЕРНОЗНОГО ВВЕДЕНИЯ	ЛИОФ-Т Д/ПРИГ Р-РА Д/ ВНУТРИКАВЕРНОЗНОГО ВВЕД																							
ЛИОФИЛИЗАТ ДЛЯ ПРИГОТОВЛЕНИЯ РАСТВОРА ДЛЯ ВНУТРИКАВЕРНОЗНОГО ВВЕДЕНИЯ	ЛИОФ-Т Д/ПРИГ-Я Р-РА Д/ В/КАВЕРНОЗНОГО ВВЕД																							
ЛИОФИЛИЗАТ ДЛЯ ПРИГОТОВЛЕНИЯ РАСТВОРА ДЛЯ ВНУТРИКАВЕРНОЗНОГО ВВЕДЕНИЯ	ЛИОФ-Т Д/ПРИГ-Я Р-РА Д/ ВНУТРИКАВЕРНОЗНОГО ВВЕД																							
ЛИОФИЛИЗАТ ДЛЯ ПРИГОТОВЛЕНИЯ РАСТВОРА ДЛЯ ВНУТРИКАВЕРНОЗНОГО ВВЕДЕНИЯ	ЛИОФ-Т Д/ПРИГ-Я Р-РА Д/В/КАВЕРНОЗНОГО ВВЕД																							
ЛИОФИЛИЗАТ ДЛЯ ПРИГОТОВЛЕНИЯ РАСТВОРА ДЛЯ ВНУТРИКАВЕРНОЗНОГО ВВЕДЕНИЯ	ЛИОФ-Т Д/ПРИГ-Я Р-РА Д/ВНУТРИКАВЕРНОЗНОГО ВВЕД																							
ЛИОФИЛИЗАТ ДЛЯ ПРИГОТОВЛЕНИЯ РАСТВОРА ДЛЯ ВНУТРИКАВЕРНОЗНОГО ВВЕДЕНИЯ	ЛИОФИЛ Д/ ПРИГ Р-РА Д/ ВНУТРИКАВЕРНОЗНОГО ВВЕД																							
ЛИОФИЛИЗАТ ДЛЯ ПРИГОТОВЛЕНИЯ РАСТВОРА ДЛЯ ВНУТРИКАВЕРНОЗНОГО ВВЕДЕНИЯ	ЛИОФИЛ Д/ПРИГ Р-РА Д/ВНУТРИКАВЕРНОЗ ВВЕД																							
НАБОР ДЛЯ ПРИГОТОВЛЕНИЯ РАСТВОРОВ ДЛЯ ИНФУЗИЙ (КОНЦЕНТРАТ+ЛИОФИЛИЗАТ)	НАБОР Д/ ПРИГ Р-ОВ Д/ИНФ (КОНЦ+ЛИОФ)																							
ПЕРЧАТКИ СМОТРОВЫЕ НИТРИЛОВЫЕ НЕСТЕРИЛЬНЫЕ НЕОПУДРЕННЫЕ СИНТЕТИЧЕСКИЕ	ПЕРЧ СМОТР НИТРИЛ НЕСТЕР НЕОПУДР СИНТ																							
РАСТВОР ДЛЯ ВНУТРИМЫШЕЧНОГО И ОКОЛОСУСТАВНОГО ВВЕДЕНИЯ ГОМЕОПАТИЧЕСКИЙ	Р-Р Д/В/М И ОКОЛОСУСТАС ВВЕД ГОМЕОПАТ																							
 ТАБЛЕТКИ С КОНТРОЛИРУЕМЫМ ВЫСВОБОЖДЕНИЕМ ПОКРЫТЫЕ ПЛЕНОЧНОЙ ОБОЛОЧКОЙ 	 ТАБ П/ПЛЕН/О С КОНТРОЛ ВЫСВОБОЖ 																							
 ТАБЛЕТКИ С КОНТРОЛИРУЕМЫМ ВЫСВОБОЖДЕНИЕМ ПОКРЫТЫЕ ПЛЕНОЧНОЙ ОБОЛОЧКОЙ 	 ТАБ П/ПЛЕН/О С КОНТРОЛ ВЫСВОБОЖД 																							
 ТАБЛЕТКИ ПРОЛОНГИРОВАННОГО ВЫСВОБОЖДЕНИЯ ПОКРЫТЫЕ ПЛЕНОЧНОЙ ОБОЛОЧКОЙ 	 ТАБ ПРОЛОНГ ВЫСВОБОЖД П/ПЛЕН/О 																							
 ТАБЛЕТКИ С КОНТРОЛИРУЕМЫМ ВЫСВОБОЖДЕНИЕМ ПОКРЫТЫЕ ПЛЕНОЧНОЙ ОБОЛОЧКОЙ 	 ТАБ С КОНТРОЛ ВЫСВОБОЖД П/ПЛЕН/О 																							
ТАБЛЕТКИ С ПРОЛОНГИРОВАННЫМ ВЫСВОБОЖДЕНИЕМ ПОКРЫТЫЕ ПЛЕНОЧНОЙ ОБОЛОЧКОЙ	ТАБ. С ПРОЛОНГ. ВЫСВОБ. П/О																							
ГРАНУЛЫ ПОКРЫТЫЕ КИШЕЧНОРАСТВОРИМОЙ ОБОЛОЧКОЙ ПРОЛОНГИРОВАННОГО ДЕЙСТВИЯ	ГРАН П/О КИШЕЧНОРАСТВ ПРОЛОНГ ДЕЙСТВ																							
ЛИОФИЛИЗАТ ДЛЯ ПРИГОТОВЛЕНИЯ РАСТВОРА ДЛЯ ИНЪЕКЦИЙ И МЕСТНОГО ПРИМЕНЕНИЯ	ЛИОФ-Т Д/ ПРИГ Р-РА Д/ ИН И МЕСТН ПРИМ																							
ЛИОФИЛИЗАТ ДЛЯ ПРИГОТОВЛЕНИЯ РАСТВОРА ДЛЯ ИНЪЕКЦИЙ И МЕСТНОГО ПРИМЕНЕНИЯ	ЛИОФ-Т Д/ПРИГ Р-РА Д/ ИН И МЕСТН ПРИМ																							
ЛИОФИЛИЗАТ ДЛЯ ПРИГОТОВЛЕНИЯ РАСТВОРА ДЛЯ ИНЪЕКЦИЙ И МЕСТНОГО ПРИМЕНЕНИЯ	ЛИОФ-Т Д/ПРИГ-Я Р-РА Д/ИН И МЕСТН ПРИМ																							
ЛИОФИЛИЗАТ ДЛЯ ПРИГОТОВЛЕНИЯ РАСТВОРА ДЛЯ ИНЪЕКЦИЙ И МЕСТНОГО ПРИМЕНЕНИЯ	ЛИОФИЛ Д/ ПРИГ Р-РА Д/ ИН И МЕСТН ПРИМ																							
ЛИОФИЛИЗАТ ДЛЯ ПРИГОТОВЛЕНИЯ РАСТВОРА ДЛЯ ИНЪЕКЦИЙ И МЕСТНОГО ПРИМЕНЕНИЯ	ЛИОФИЛ Д/ПРИГ Р-РА Д/ИН И МЕСТН ПРИМ																							
ПЕРЧАТКИ СМОТРОВЫЕ НИТРИЛОВЫЕ НЕСТЕРИЛЬНЫЕ НЕОПУДРЕННЫЕ ТЕКСТУРИРОВАННЫЕ	ПЕРЧ СМОТР НИТРИЛ НЕСТЕР НЕОПУДР ТЕКСТУР																							
ГРАНУЛЫ ДЛЯ ПРИГОТОВЛЕНИЯ СУСПЕНЗИИ СО ВКУСОМ АПЕЛЬСИНА ДЛЯ ПРИЕМА ВНУТРЬ	ГРАН Д/ПРИГ СУСП СО ВКУСОМ АПЕЛ																							
ЛИОФИЛИЗАТ ДЛЯ ПРИГОТОВЛЕНИЯ РАСТВОРА ДЛЯ МЕСТНОГО И НАРУЖНОГО ПРИМЕНЕНИЯ	ЛИОФИЛ Д/ПРИГ Р-РА Д/МЕСТН И НАРУЖ ПРИМ																							
 ТАБЛЕТКИ ДЛЯ ПРИГОТОВЛЕНИЯ РАСТВОРА ДЛЯ МЕСТНОГО И НАРУЖНОГО ПРИМЕНЕНИЯ 	 ТАБ Д/ПРИГ Р-РА Д/МЕСТН И НАРУЖ ПРИМ 																							
 ТАБЛЕТКИ ДЛЯ ПРИГОТОВЛЕНИЯ РАСТВОРА ДЛЯ МЕСТНОГО И НАРУЖНОГО ПРИМЕНЕНИЯ 	 ТАБ Д/ПРИГ Р-РА Д/МЕСТН/НАРУЖ ПРИМ 																							
 ТАБЛЕТКИ С ПРОЛОНГИРОВАННЫМ ВЫСВОБОЖДЕНИЕМ ПОКРЫТЫЕ ПЛЕНОЧНОЙ ОБОЛОЧКОЙ 	 ТАБ П/ПЛЕН/О ПРОЛОНГ ДЕЙСТВ 																							
 ТАБЛЕТКИ С МОДИФИЦИРОВАННЫМ ВЫСВОБОЖДЕНИЕМ ПОКРЫТЫЕ ПЛЕНОЧНОЙ ОБОЛОЧКОЙ 	 ТАБ П/ПЛЕН/О С МОДИФИЦ ВЫСВОБОЖ 																							
 ТАБЛЕТКИ С МОДИФИЦИРОВАННЫМ ВЫСВОБОЖДЕНИЕМ ПОКРЫТЫЕ ПЛЕНОЧНОЙ ОБОЛОЧКОЙ 	 ТАБ С МОДИФИЦ ВЫСВОБОЖД П/ПЛЕН/О 																							
 ТАБЛЕТКИ С ПРОЛОНГИРОВАННЫМ ВЫСВОБОЖДЕНИЕМ ПОКРЫТЫЕ ПЛЕНОЧНОЙ ОБОЛОЧКОЙ 	 ТАБ С ПРОЛОНГ ВЫСВОБОЖД П/ПЛЕН/О 																							
БИНТ МЕДИЦИНСКИЙ ЭЛАСТИЧНЫЙ ТРУБЧАТЫЙ Д/ФИКСАЦИИ ГОЛЕНОСТОПНОГО СУСТАВА №1	БИНТ МЕД ЭЛАСТ ТРУБЧ Д/ФИКС ГОЛЕНОСТОП СУСТ №1																							
БИНТ МЕДИЦИНСКИЙ ЭЛАСТИЧНЫЙ ТРУБЧАТЫЙ Д/ФИКСАЦИИ ГОЛЕНОСТОПНОГО СУСТАВА №2	БИНТ МЕД ЭЛАСТ ТРУБЧ Д/ФИКС ГОЛЕНОСТОП СУСТ №2																							
БИНТ МЕДИЦИНСКИЙ ЭЛАСТИЧНЫЙ ТРУБЧАТЫЙ Д/ФИКСАЦИИ ГОЛЕНОСТОПНОГО СУСТАВА №3	БИНТ МЕД ЭЛАСТ ТРУБЧ Д/ФИКС ГОЛЕНОСТОП СУСТ №3																							
ПОРОШОК ДЛЯ ПРИГОТОВЛЕНИЯ РАСТВОРА ДЛЯ ПРИЕМА ВНУТРЬ И МЕСТНОГО ПРИМЕНЕНИЯ	ПОР Д/ПРИГ Р-РА Д/ПРИЕМА ВНУТРЬ И МЕСТН ПРИМ																							
 ТАБЛЕТКИ ПРОЛОНГИРОВАННОГО ДЕЙСТВИЯ ПОКРЫТЫЕ КИШЕЧНОРАСТВОРИМОЙ ОБОЛОЧКОЙ 	 ТАБ ПОКР К/Р-РИМОЙ ОБОЛ ПРОЛОНГ ДЕЙСТВ 																							
 ТАБЛЕТКИ ПРОЛОНГИРОВАННОГО ДЕЙСТВИЯ ПОКРЫТЫЕ КИШЕЧНОРАСТВОРИМОЙ ОБОЛОЧКОЙ 	 ТАБ ПОКР КИШЕЧНОР-РИМОЙ ОБОЛ ПРОЛОНГ ДЕЙСТВ 																							
 ТАБЛЕТКИ ПРОЛОНГИРОВАННОГО ДЕЙСТВИЯ ПОКРЫТЫЕ КИШЕЧНОРАСТВОРИМОЙ ОБОЛОЧКОЙ 	 ТАБ ПРОЛОНГ ДЕЙСТВ ПОКР КИШЕЧНОР-РИМОЙ ОБОЛ 																							
ПОРОШОК ДЛЯ ПРИГОТОВЛЕНИЯ КОНЦЕНТРАТА ДЛЯ ПРИГОТОВЛЕНИЯ РАСТВОРА ДЛЯ ИНФУЗИЙ	ПОР Д/ ПРИГ КОНЦЕНТРАТА Д/ ПРИГ Р-РА Д/ ИНФ																							
ПОРОШОК ДЛЯ ПРИГОТОВЛЕНИЯ КОНЦЕНТРАТА ДЛЯ ПРИГОТОВЛЕНИЯ РАСТВОРА ДЛЯ ИНФУЗИЙ	ПОР Д/ПРИГ КОНЦ Д/ПРИГ Р-РА Д/ИНФ																							
ПОРОШОК ДЛЯ ПРИГОТОВЛЕНИЯ РАСТВОРА ДЛЯ ВНУТРИМЫШЕЧНОГО И ПОДКОЖНОГО ВВЕДЕНИЯ	ПОР Д/ПРИГ Р-РА Д/В/М И П/К ВВЕД																							
ПОРОШОК ДЛЯ ПРИГОТОВЛЕНИЯ КОНЦЕНТРАТА ДЛЯ ПРИГОТОВЛЕНИЯ РАСТВОРА ДЛЯ ИНФУЗИЙ	ПОР Д/ПРИГР-РА Д/ИНФ																							
КОНЦЕНТРАТ ДЛЯ ПРИГОТОВЛЕНИЯ РАСТВОРА ДЛЯ ИНФУЗИЙ И ВНУТРИБРЮШИННОГО ВВЕДЕНИЯ	КОНЦ Д/ПРИГ Р-РА Д/ИНФ И В/БРЮШИН ВВЕД																							
ЛИОФИЛИЗАТ ДЛЯ ПРИГОТОВЛЕНИЯ РАСТВОРА ДЛЯ ПРИЕМА ВНУТРЬ И МЕСТНОГО ПРИМЕНЕНИЯ	ЛИОФ-Т Д/ ПРИГ Р-РА Д/ ПРИЕМА ВНУТРЬ И МЕСТН ПРИМ																							
ЛИОФИЛИЗАТ ДЛЯ ПРИГОТОВЛЕНИЯ РАСТВОРА ДЛЯ ПРИЕМА ВНУТРЬ И МЕСТНОГО ПРИМЕНЕНИЯ	ЛИОФ-Т Д/ПРИГ Р-РА Д/ ПРИЕМА ВНУТРЬ И МЕСТН ПРИМ																							
ЛИОФИЛИЗАТ ДЛЯ ПРИГОТОВЛЕНИЯ РАСТВОРА ДЛЯ ПРИЕМА ВНУТРЬ И МЕСТНОГО ПРИМЕНЕНИЯ	ЛИОФ-Т Д/ПРИГ-Я Р-РА Д/ ПРИЕМА ВНУТРЬ И МЕСТН ПРИМ																							
ЛИОФИЛИЗАТ ДЛЯ ПРИГОТОВЛЕНИЯ РАСТВОРА ДЛЯ ПРИЕМА ВНУТРЬ И МЕСТНОГО ПРИМЕНЕНИЯ	ЛИОФ-Т Д/ПРИГ-Я Р-РА Д/ПРИЕМА ВНУТРЬ И МЕСТН ПРИМ																							
ЛИОФИЛИЗАТ ДЛЯ ПРИГОТОВЛЕНИЯ РАСТВОРА ДЛЯ ПРИЕМА ВНУТРЬ И МЕСТНОГО ПРИМЕНЕНИЯ	ЛИОФИЛ Д/ ПРИГ Р-РА Д/ ПРИЕМА ВНУТРЬ И МЕСТН ПРИМ																							
ЛИОФИЛИЗАТ ДЛЯ ПРИГОТОВЛЕНИЯ РАСТВОРА ДЛЯ ВНУТРИВЕННОГО И ПОДКОЖНОГО ВВЕДЕНИЯ	ЛИОФИЛ Д/ПРИГ Р-РА Д/В/В И П/К ВВЕД																							
ЛИОФИЛИЗАТ ДЛЯ ПРИГОТОВЛЕНИЯ РАСТВОРА ДЛЯ ПРИЕМА ВНУТРЬ И МЕСТНОГО ПРИМЕНЕНИЯ	ЛИОФИЛ Д/ПРИГ Р-РА Д/ПРИЕМА ВНУТРЬ И МЕСТН ПРИМ																							
ЛИОФИЛИЗАТ ДЛЯ ПРИГОТОВЛЕНИЯ СУСПЕНЗИИ ДЛЯ ИНЪЕКЦИЙ ПРОЛОНГИРОВАННОГО ДЕЙСТВИЯ	ЛИОФ-Т Д/ ПРИГ СУСП Д/ ИН ПРОЛОНГ ДЕЙСТВ																							
ЛИОФИЛИЗАТ ДЛЯ ПРИГОТОВЛЕНИЯ СУСПЕНЗИИ ДЛЯ ИНЪЕКЦИЙ ПРОЛОНГИРОВАННОГО ДЕЙСТВИЯ	ЛИОФ-Т Д/ПРИГ СУСП Д/ ИН ПРОЛОНГ ДЕЙСТВ																							
ЛИОФИЛИЗАТ ДЛЯ ПРИГОТОВЛЕНИЯ СУСПЕНЗИИ ДЛЯ ИНЪЕКЦИЙ ПРОЛОНГИРОВАННОГО ДЕЙСТВИЯ	ЛИОФ-Т Д/ПРИГ-Я СУСП Д/ИНЪЕКЦ ПРОЛОНГИР Д-Я																							
ЛИОФИЛИЗАТ ДЛЯ ПРИГОТОВЛЕНИЯ СУСПЕНЗИИ ДЛЯ ИНЪЕКЦИЙ ПРОЛОНГИРОВАННОГО ДЕЙСТВИЯ	ЛИОФИЛ Д/ ПРИГ СУСП Д/ ИН ПРОЛОНГ ДЕЙСТВ																							
ЛИОФИЛИЗАТ ДЛЯ ПРИГОТОВЛЕНИЯ СУСПЕНЗИИ ДЛЯ ПРИЕМА ВНУТРЬ И МЕСТНОГО ПРИМЕНЕНИЯ	ЛИОФИЛ Д/ПРИГ СУСПД/ПРИЕМА ВНУТРЬ И МЕСТН ПРИМ																							
РАСТВОР ДЛЯ ВНУТРИМЫШЕЧНОГО СУБКОНЪЮНКТИВАЛЬНОГО ВВЕДЕНИЯ И ЗАКАПЫВАНИЯ В ГЛАЗ	Р-Р Д/В/М СУБКОНЪЮКТ ВВЕД И ЗАКАП В ГЛАЗ																							
ЛИОФИЛИЗАТ ДЛЯ ПРИГОТОВЛЕНИЯ КОНЦЕНТРАТА ДЛЯ ПРИГОТОВЛЕНИЯ РАСТВОРА ДЛЯ ИНФУЗИЙ	ЛИОФ-Т Д/ ПРИГ КОНЦЕНТРАТА Д/ ПРИГ Р-РА Д/ ИНФ																							
ЛИОФИЛИЗАТ ДЛЯ ПРИГОТОВЛЕНИЯ РАСТВОРА ДЛЯ ВНУТРИМЫШЕЧНОГО И ПОДКОЖНОГО ВВЕДЕНИЯ	ЛИОФ-Т Д/ ПРИГ Р-РА Д/ В/М И П/К ВВЕД																							
ЛИОФИЛИЗАТ ДЛЯ ПРИГОТОВЛЕНИЯ КОНЦЕНТРАТА ДЛЯ ПРИГОТОВЛЕНИЯ РАСТВОРА ДЛЯ ИНФУЗИЙ	ЛИОФ-Т Д/ПРИГ КОНЦЕНТРАТА Д/ ПРИГ Р-РА Д/ ИНФУЗ																							
ЛИОФИЛИЗАТ ДЛЯ ПРИГОТОВЛЕНИЯ РАСТВОРА ДЛЯ ВНУТРИМЫШЕЧНОГО И ПОДКОЖНОГО ВВЕДЕНИЯ	ЛИОФ-Т Д/ПРИГ Р-РА Д/ В/М И П/К ВВЕД																							
ЛИОФИЛИЗАТ ДЛЯ ПРИГОТОВЛЕНИЯ КОНЦЕНТРАТА ДЛЯ ПРИГОТОВЛЕНИЯ РАСТВОРА ДЛЯ ИНФУЗИЙ	ЛИОФ-Т Д/ПРИГ-Я КОНЦ Д/ ПРИГ Р-РА Д/ ИНФ																							
ЛИОФИЛИЗАТ ДЛЯ ПРИГОТОВЛЕНИЯ КОНЦЕНТРАТА ДЛЯ ПРИГОТОВЛЕНИЯ РАСТВОРА ДЛЯ ИНФУЗИЙ	ЛИОФ-Т Д/ПРИГ-Я КОНЦ Д/ПРИГ Р-РА Д/ИНФ																							
ЛИОФИЛИЗАТ ДЛЯ ПРИГОТОВЛЕНИЯ КОНЦЕНТРАТА ДЛЯ ПРИГОТОВЛЕНИЯ РАСТВОРА ДЛЯ ИНФУЗИЙ	ЛИОФ-Т Д/ПРИГ-Я КОНЦ Д/ПРИГ-Я Р-РА Д/ ИНФ																							
ЛИОФИЛИЗАТ ДЛЯ ПРИГОТОВЛЕНИЯ КОНЦЕНТРАТА ДЛЯ ПРИГОТОВЛЕНИЯ РАСТВОРА ДЛЯ ИНФУЗИЙ	ЛИОФ-Т Д/ПРИГ-Я КОНЦЕНТРАТА Д/ ПРИГ Р-РА Д/ ИНФ																							
ЛИОФИЛИЗАТ ДЛЯ ПРИГОТОВЛЕНИЯ РАСТВОРА ДЛЯ ВНУТРИМЫШЕЧНОГО И ПОДКОЖНОГО ВВЕДЕНИЯ	ЛИОФ-Т Д/ПРИГ-Я Р-РА Д/ В/М И П/К ВВЕД																							
ЛИОФИЛИЗАТ ДЛЯ ПРИГОТОВЛЕНИЯ РАСТВОРА ДЛЯ ВНУТРИМЫШЕЧНОГО И ПОДКОЖНОГО ВВЕДЕНИЯ	ЛИОФ-Т Д/ПРИГ-Я Р-РА Д/В/М И П/К ВВЕД																							
ЛИОФИЛИЗАТ ДЛЯ ПРИГОТОВЛЕНИЯ КОНЦЕНТРАТА ДЛЯ ПРИГОТОВЛЕНИЯ РАСТВОРА ДЛЯ ИНФУЗИЙ	ЛИОФИЛ Д/ ПРИГ КОНЦЕНТРАТА Д/ ПРИГ Р-РА Д/ ИНФ																							
ЛИОФИЛИЗАТ ДЛЯ ПРИГОТОВЛЕНИЯ РАСТВОРА ДЛЯ ВНУТРИМЫШЕЧНОГО И ПОДКОЖНОГО ВВЕДЕНИЯ	ЛИОФИЛ Д/ ПРИГ Р-РА Д/ В/М И П/К ВВЕД																							
ЛИОФИЛИЗАТ ДЛЯ ПРИГОТОВЛЕНИЯ РАСТВОРА ДЛЯ ВНУТРИМЫШЕЧНОГО И ПОДКОЖНОГО ВВЕДЕНИЯ	ЛИОФИЛ Д/ПРИГ Р-РА Д/В/М И П/К ВВЕД																							
ЛИОФИЛИЗАТ ДЛЯ ПРИГОТОВЛЕНИЯ РАСТВОРА ДЛЯ МЕСТНОГО И ПАРЕНТЕРАЛЬНОГО ПРИМЕНЕНИЯ	ЛИОФИЛ Д/ПРИГ Р-РА Д/МЕСТН И ПАРЕНТЕРАЛЬНОГО ПРИМ																							
ЛИОФИЛИЗАТ ДЛЯ ПРИГОТОВЛЕНИЯ РАСТВОРА ДЛЯ ПОДКОЖНОГО И ВНУТРИМЫШЕЧНОГО ВВЕДЕНИЯ	ЛИОФИЛ Д/ПРИГ Р-РА Д/П/К И В/М ВВЕД																							
ЛИОФИЛИЗИРОВАННЫЙ ПОРОШОК ДЛЯ ПРИГОТОВЛЕНИЯ РАСТВОРА ДЛЯ ВНУТРИВЕННОГО ВВЕДЕНИЯ	ЛИОФИЛ ПОР Д/В/В ВВЕД																							
ПОРОШОК ДЛЯ ПРИГОТОВЛЕНИЯ РАСТВОРА ДЛЯ ВНУТРИВЕННОГО И ВНУТРИМЫШЕЧНОГО ВВЕДЕНИЯ	ПОР Д/ ПРИГ Р-РА Д/ В/В И В/М ВВЕД																							
ПОРОШОК ДЛЯ ПРИГОТОВЛЕНИЯ РАСТВОРА ДЛЯ ВНУТРИВЕННОГО И ВНУТРИМЫШЕЧНОГО ВВЕДЕНИЯ	ПОР Д/ИН В/В В/М																							
ПОРОШОК ДЛЯ ПРИГОТОВЛЕНИЯ РАСТВОРА ДЛЯ ВНУТРИВЕННОГО И ВНУТРИМЫШЕЧНОГО ВВЕДЕНИЯ	ПОР Д/ПРИГ Р-РА Д/В/В И В/М ВВЕД																							
ПОРОШОК ДЛЯ ПРИГОТОВЛЕНИЯ РАСТВОРА ДЛЯ ВНУТРИВЕННОГО И ВНУТРИМЫШЕЧНОГО ИНЪЕКЦИЙ	ПОР Д/ПРИГ Р-РА Д/В/В И В/М ИН																							
ПОРОШОК ДЛЯ ПРИГОТОВЛЕНИЯ РАСТВОРА ДЛЯ ВНУТРИВЕННОГО И ВНУТРИМЫШЕЧНОГО ВВЕДЕНИЯ	ПОР Д/Р-РА В/В В/М																							
ПОРОШОК ДЛЯ ПРИГОТОВЛЕНИЯ РАСТВОРА ДЛЯ ВНУТРИВЕННОГО И ВНУТРИМЫШЕЧНОГО ВВЕДЕНИЯ	ПОР.Д/Р-РА Д/В/В И В/М ВВЕД.																							
ЛИОФИЛИЗАТ ДЛЯ ПРИГОТОВЛЕНИЯ СУСПЕНЗИИ ДЛЯ ВНУТРИМЫШЕЧНОГО И ПОДКОЖНОГО ВВЕДЕНИЯ	ЛИОФ-Т Д/ ПРИГ СУСП Д/ В/М И П/К ВВЕД																							
ЛИОФИЛИЗАТ ДЛЯ ПРИГОТОВЛЕНИЯ СУСПЕНЗИИ ДЛЯ ВНУТРИМЫШЕЧНОГО И ПОДКОЖНОГО ВВЕДЕНИЯ	ЛИОФ-Т Д/ПРИГ СУСП Д/ В/М И П/К ВВЕД																							
ЛИОФИЛИЗАТ ДЛЯ ПРИГОТОВЛЕНИЯ СУСПЕНЗИИ ДЛЯ ВНУТРИМЫШЕЧНОГО И ПОДКОЖНОГО ВВЕДЕНИЯ	ЛИОФ-Т Д/ПРИГ-Я СУСП Д/В/М И П/К ВВЕД																							
ЛИОФИЛИЗАТ ДЛЯ ПРИГОТОВЛЕНИЯ СУСПЕНЗИИ ДЛЯ ВНУТРИМЫШЕЧНОГО И ПОДКОЖНОГО ВВЕДЕНИЯ	ЛИОФИЛ Д/ ПРИГ СУСП Д/ В/М И П/К ВВЕД																							
ЛИОФИЛИЗАТ ДЛЯ ПРИГОТОВЛЕНИЯ СУСПЕНЗИИ ДЛЯ ВНУТРИМЫШЕЧНОГО И ПОДКОЖНОГО ВВЕДЕНИЯ	ЛИОФИЛ Д/ПРИГ СУСПД/В/М И П/К ВВЕД																							
ЛИОФИЛИЗАТ ДЛЯ ПРИГОТОВЛЕНИЯ РАСТВОРА ДЛЯ ВНУТРИПЛЕВРАЛЬНОГО ВВЕДЕНИЯ И ИНГАЛЯЦИЙ	ЛИОФИЛ Д/ПРИГ Р-РА Д/ВНУТРИПЛЕВР ВВЕД И ИНГ																							
РАСТВОР ДЛЯ НАКОЖНОГО СКАРИФИКАЦИОННОГО НАНЕСЕНИЯ ВНУТРИКОЖНОГО И ПОДКОЖНОГО ВВЕД	Р-Р Д/НАКОЖ СКАРИФИКАЦ НАНЕС В/К И П/К ВВЕД																							
 ТАБЛЕТКИ ШИПУЧИЕ ДЛЯ ПРИГОТОВЛЕНИЯ РАСТВОРА ДЛЯ МЕСТНОГО И НАРУЖНОГО ПРИМЕНЕНИЯ 	 ТАБ ШИП Д/ПРИГ Р-РА Д/МЕСТН/НАРУЖ ПРИМ 																							
ГРАНУЛЫ С ЗАМЕДЛЕННЫМ ВЫСВОБОЖДЕНИЕМ ДЛЯ ПРИГОТОВЛЕНИЯ СУСПЕНЗИИ ДЛЯ ПРИЕМА ВНУТРЬ	ГРАН С ЗАМЕДЛ ВЫСВОБОЖД Д/ПРИГ СУСП Д/ПРИЕМА ВНУТРЬ																							
ЛИОФИЛИЗАТ ДЛЯ ПРИГОТОВЛЕНИЯ РАСТВОРА ДЛЯ ВНУТРИВЕННОГО И ВНУТРИМЫШЕЧНОГО ВВЕДЕНИЯ	ЛИОФИЛ Д/ПРИГ Р-РА Д/ В/В И В/М ВВЕД																							
ЛИОФИЛИЗАТ ДЛЯ ПРИГОТОВЛЕНИЯ РАСТВОРА ДЛЯ ВНУТРИВЕННОГО И ВНУТРИМЫШЕЧНОГО ВВЕДЕНИЯ	ЛИОФИЛ Д/ПРИГ Р-РА Д/В/В И В/М ВВЕД																							
КОНЦЕНТРАТ ДЛЯ ПРИГОТОВЛЕНИЯ РАСТВОРА ДЛЯ ВНУТРИВЕННОГО И ВНУТРИПОЛОСТНОГО ВВЕДЕНИЯ	КОНЦ Д/ПРИГ Р-РА Д/В/В И В/ПОЛОСТ ВВЕД																							
ЛИОФИЛИЗАТ ДЛЯ ПРИГОТОВЛЕНИЯ РАСТВОРА ДЛЯ ВНУТРИМЫШЕЧНОГО И ПАРАБУЛЬБАРНОГО ВВЕДЕНИЯ	ЛИОФ-Т Д/ ПРИГ Р-РА Д/ В/М И ПАРАБУЛЬБАР ВВЕД																							
ЛИОФИЛИЗАТ ДЛЯ ПРИГОТОВЛЕНИЯ РАСТВОРА ДЛЯ ВНУТРИМЫШЕЧНОГО И ПАРАБУЛЬБАРНОГО ВВЕДЕНИЯ	ЛИОФ-Т Д/ПРИГ Р-РА Д/ В/М И ПАРАБУЛЬБАР ВВЕД																							
ЛИОФИЛИЗАТ ДЛЯ ПРИГОТОВЛЕНИЯ РАСТВОРА ДЛЯ ВНУТРИМЫШЕЧНОГО И ПАРАБУЛЬБАРНОГО ВВЕДЕНИЯ	ЛИОФ-Т Д/ПРИГ-Я Р-РА Д/ В/М И ПАРАБУЛЬБАР ВВЕД																							
ЛИОФИЛИЗАТ ДЛЯ ПРИГОТОВЛЕНИЯ РАСТВОРА ДЛЯ ВНУТРИМЫШЕЧНОГО И ПАРАБУЛЬБАРНОГО ВВЕДЕНИЯ	ЛИОФ-Т Д/ПРИГ-Я Р-РА Д/В/М И ПАРАБУЛЬБАР ВВЕД																							
ЛИОФИЛИЗАТ ДЛЯ ПРИГОТОВЛЕНИЯ РАСТВОРА ДЛЯ ВНУТРИМЫШЕЧНОГО И ПАРАБУЛЬБАРНОГО ВВЕДЕНИЯ	ЛИОФИЛ Д/ ПРИГ Р-РА Д/ В/М И ПАРАБУЛЬБАР ВВЕД																							
ЛИОФИЛИЗАТ ДЛЯ ПРИГОТОВЛЕНИЯ РАСТВОРА ДЛЯ ВНУТРИМЫШЕЧНОГО И ПАРАБУЛЬБАРНОГО ВВЕДЕНИЯ	ЛИОФИЛ Д/ПРИГ Р-РА Д/В/М И ПАРАБУЛЬБАР ВВЕД																							
РАСТВОР ДЛЯ НАКОЖНОГО СКАРИФИКАЦИОННОГО НАНЕСЕНИЯ ВНУТРИКОЖНОГО И ПОДКОЖНОГО ВЕДЕНИЯ	Р-Р Д/ НАКОЖ СКАРИФИКАЦ НАНЕС ВНУТРИКОЖ И П/К ВВЕД																							
КОНЦЕНТРАТ ДЛЯ ПРИГОТОВЛЕНИЯ РАСТВОРА ДЛЯ ВНУТРИВЕННОГО И ВНУТРИПЛЕВРАЛЬНОГО ВВЕДЕНИЯ	КОНЦ Д/ПРИГ Р-РА Д/ В/В И ВНУТРИПЛЕВРАЛЬНОГО ВВЕД																							
КОНЦЕНТРАТ ДЛЯ ПРИГОТОВЛЕНИЯ РАСТВОРА ДЛЯ ВНУТРИВЕННОГО И ВНУТРИПЛЕВРАЛЬНОГО ВВЕДЕНИЯ	КОНЦ Д/ПРИГ Р-РА Д/В/В И В/ПЛЕВР ВВЕД																							
КОНЦЕНТРАТ ДЛЯ ПРИГОТОВЛЕНИЯ РАСТВОРА ДЛЯ ВНУТРИВЕННОГО И ВНУТРИПЛЕВРАЛЬНОГО ВВЕДЕНИЯ	КОНЦ Д/ПРИГ Р-РА Д/В/В И В/ПЛЕВРАЛ ВВЕД																							
РАСТВОР ДЛЯ НАКОЖНОГО СКАРИФИКАЦИОННОГО НАНЕСЕНИЯ ВНУТРИКОЖНОГО И ПОДКОЖНОГО ВВЕДЕНИЯ	Р-Р Д/НАКОЖ СКАРИФИКАЦ НАНЕС ВНУТРИКОЖ И П/К ВВЕД																							
КОНЦЕНТРАТ ДЛЯ ПРИГОТОВЛЕНИЯ РАСТВОРА ДЛЯ ВНУТРИВЕННОГО И ВНУТРИАРТЕРИАЛЬНОГО ВВЕДЕНИЯ	КОНЦ Д/ПРИГ Р-РА Д/В/В И В/А ВВЕД																							
КОНЦЕНТРАТ ДЛЯ ПРИГОТОВЛЕНИЯ РАСТВОРА ДЛЯ ВНУТРИСОСУДИСТОГО И ВНУТРИПУЗЫРНОГО ВВЕДЕНИЯ	КОНЦ Д/ПРИГ Р-РА Д/В/СОСУД И В/ПУЗЫР ВВЕД																							
КОНЦЕНТРАТ ДЛЯ ПРИГОТОВЛЕНИЯ РАСТВОРА ДЛЯ МЕСТНОГО И НАРУЖНОГО ПРИМЕНЕНИЯ СПИРТОВОЙ 2%	КОНЦ Д/ПРИГ Р-РА Д/МЕСТН И НАРУЖ ПРИМ СПИРТ																							
ЛИОФИЛИЗАТ ДЛЯ ПРИГОТОВЛЕНИЯ РАСТВОРА ДЛЯ ВНУТРИВЕННОГО И ВНУТРИАРТЕРИАЛЬНОГО ВВЕДЕНИЯ	ЛИОФИЛ Д/ПРИГ Р-РА Д/В/В И В/А ВВЕД																							
ЛИОФИЛИЗАТ ДЛЯ ПРИГОТОВЛЕНИЯ РАСТВОРА ДЛЯ ВНУТРИСОСУДИСТОГО И ВНУТРИПУЗЫРНОГО ВВЕДЕНИЯ	ЛИОФИЛ Д/ПРИГ Р-РА Д/ВНУТРИСОСУД И ВНУТРИПУЗЫР ВВЕД																							
ЛИОФИЛИЗАТ ДЛЯ ПРИГОТОВЛЕНИЯ РАСТВОРА ДЛЯ ИНТРАНАЗАЛЬНОГО ВВЕДЕНИЯ И ДЛЯ ПРИЕМА ВНУТРЬ	ЛИОФИЛ Д/ПРИГ Р-РА Д/ИНТРАНАЗ ВВЕД И Д/ПРИЕМА ВНУТРЬ																							
ПОРОШОК ДЛЯ ПРИГОТОВЛЕНИЯ СУСПЕНЗИИ ДЛЯ ПОДКОЖНОГО ВВЕДЕНИЯ ПРОЛОНГИРОВАННОГО ДЕЙСТВИЯ	ПОР Д/ ПРИГ СУСП Д/ П/К ВВЕД ПРОЛОНГ ДЕЙСТВ																							
ПОРОШОК ДЛЯ ПРИГОТОВЛЕНИЯ СУСПЕНЗИИ ДЛЯ ПОДКОЖНОГО ВВЕДЕНИЯ ПРОЛОНГИРОВАННОГО ДЕЙСТВИЯ	ПОР Д/ПРИГ СУСП Д/П/К ВВЕД ПРОЛОНГ Д-Я																							
ПОРОШОК ДЛЯ ПРИГОТОВЛЕНИЯ СУСПЕНЗИИ ДЛЯ ПОДКОЖНОГО ВВЕДЕНИЯ ПРОЛОНГИРОВАННОГО ДЕЙСТВИЯ	ПОР Д/ПРИГ СУСП Д/П/К ВВЕД ПРОЛОНГДЕЙСТВ																							
ПОРОШОК ДЛЯ ПРИГОТОВЛЕНИЯ СУСПЕНЗИИ ДЛЯ ВНУТРИМЫШЕЧНОГО ВВЕДЕНИЯ ПРОЛОНГИРОВАННОГО ДЕЙСТВИЯ	ПОР Д/ ПРИГ СУСП Д/ В/М ВВЕД ПРОЛОНГ ДЕЙСТВ																							
ПОРОШОК ДЛЯ ПРИГОТОВЛЕНИЯ СУСПЕНЗИИ ДЛЯ ВНУТРИМЫШЕЧНОГО ВВЕДЕНИЯ ПРОЛОНГИРОВАННОГО ДЕЙСТВИЯ	ПОР Д/ПРИГ СУСП Д/В/М ВВЕД ПРОЛОНГ Д-Я																							
ПОРОШОК ДЛЯ ПРИГОТОВЛЕНИЯ СУСПЕНЗИИ ДЛЯ ВНУТРИМЫШЕЧНОГО ВВЕДЕНИЯ ПРОЛОНГИРОВАННОГО ДЕЙСТВИЯ	ПОР Д/ПРИГ СУСП Д/В/М ВВЕД ПРОЛОНГИР ДЕЙСТВ																							
ЛИОФИЛИЗАТ ДЛЯ ПРИГОТОВЛЕНИЯ РАСТВОРА ДЛЯ ВНУТРИМЫШЕЧНОГО ВВЕДЕНИЯ ПРОЛОНГИРОВАННОГО ДЕЙСТВИЯ	ЛИОФИЛ Д/ПРИГ Р-РА Д/В/М ВВЕД ПРОЛОНГ ДЕЙСТВ																							
МИКРОСФЕРЫ ДЛЯ ПРИГОТОВЛЕНИЯ СУСПЕНЗИИ ДЛЯ ВНУТРИМЫШЕЧНОГО ВВЕДЕНИЯ ПРОЛОНГИРОВАННОГО ДЕЙСТВИЯ	МК/СФЕРЫ Д/ПРИГ СУСП Д/В/М ВВЕД ПРОЛОНГ Д-Я																							
МИКРОСФЕРЫ ДЛЯ ПРИГОТОВЛЕНИЯ СУСПЕНЗИИ ДЛЯ ВНУТРИМЫШЕЧНОГО ВВЕДЕНИЯ ПРОЛОНГИРОВАННОГО ДЕЙСТВИЯ	МК/СФЕРЫ Д/ПРИГ СУСП Д/В/М ВВЕД ПРОЛОНГ ДЕЙСТВ																							
ЛИОФИЛИЗАТ ДЛЯ ПРИГОТОВЛЕНИЯ РАСТВОРА ДЛЯ ВНУТРИСОСУДИСТОГО ВВЕДЕНИЯ В КОМПЛЕКТЕ С РАСТВОРИТЕЛЕМ	ЛИОФ-Т Д/ПРИГ Р-РА Д/ ВНУТРИСОСУД ВВЕД В КОМПЛЕКТЕ С Р-РИТЕЛЕМ																							
ЛИОФИЛИЗАТ ДЛЯ ПРИГОТОВЛЕНИЯ РАСТВОРА ДЛЯ ВНУТРИСОСУДИСТОГО ВВЕДЕНИЯ В КОМПЛЕКТЕ С РАСТВОРИТЕЛЕМ	ЛИОФ-Т Д/ПРИГ-Я Р-РА Д/ ВНУТРИСОСУД ВВЕД В КОМПЛ С Р-ЛЕМ																							
ЛИОФИЛИЗАТ ДЛЯ ПРИГОТОВЛЕНИЯ РАСТВОРА ДЛЯ ВНУТРИСОСУДИСТОГО ВВЕДЕНИЯ В КОМПЛЕКСЕ С РАСТВОРИТЕЛЕМ	ЛИОФ-Т Д/ПРИГ-Я Р-РА Д/ ВНУТРИСОСУД ВВЕД В КОМПЛЕКТЕ С Р-РИТЕЛЕМ																							
ЛИОФИЛИЗАТ ДЛЯ ПРИГОТОВЛЕНИЯ РАСТВОРА ДЛЯ ВНУТРИСОСУДИСТОГО ВВЕДЕНИЯ В КОМПЛЕКТЕ С РАСТВОРИТЕЛЕМ	ЛИОФИЛ Д/ ПРИГ Р-РА Д/ ВНУТРИСОСУД ВВЕД В КОМПЛЕКТЕ С Р-РИТЕЛЕМ																							
ЛИОФИЛИЗАТ ДЛЯ ПРИГОТОВЛЕНИЯ СУСПЕНЗИИ ПРОЛОНГИРОВАННОГО ВЫСВОБОЖДЕНИЯ ДЛЯ ВНУТРИМЫШЕЧНОГО ВВЕДЕНИЯ	ЛИОФИЛ Д/ПРИГ СУСПД/В/М ВВЕД ПРОЛОНГИРДЕЙСТВ																							
ЛИОФИЛИЗАТ ДЛЯ ПРИГОТОВЛЕНИЯ СУСПЕНЗИИ ДЛЯ ПОДКОЖНОГО ВВЕДЕНИЯ И НАКОЖНОГО СКАРИФИКАЦИОННОГО НАНЕСЕНИЯ	ЛИОФ-Т Д/ ПРИГ СУСП Д/ НАКОЖ СКАРИФИКАЦ НАНЕС И П/К ВВЕД																							
ЛИОФИЛИЗАТ ДЛЯ ПРИГОТОВЛЕНИЯ ЭМУЛЬСИИ ДЛЯ ЭНДОТРАХЕАЛЬНОГО ЭНДОБРОНХИАЛЬНОГО И ИНГАЛЯЦИОННОГО ВВЕДЕНИЯ	ЛИОФ-Т Д/ ПРИГ ЭМУЛЬС Д/ ЭНДОТРАХЕАЛЬНОГО ВВЕД																							
ЛИОФИЛИЗАТ ДЛЯ ПРИГОТОВЛЕНИЯ СУСПЕНЗИИ ДЛЯ ПОДКОЖНОГО ВВЕДЕНИЯ И НАКОЖНОГО СКАРИФИКАЦИОННОГО НАНЕСЕНИЯ	ЛИОФ-Т Д/ПРИГ СУСП Д/ НАКОЖ СКАРИФИКАЦ НАНЕС И П/К ВВЕД																							
ЛИОФИЛИЗАТ ДЛЯ ПРИГОТОВЛЕНИЯ ЭМУЛЬСИИ ДЛЯ ЭНДОТРАХЕАЛЬНОГО ЭНДОБРОНХИАЛЬНОГО И ИНГАЛЯЦИОННОГО ВВЕДЕНИЯ	ЛИОФ-Т Д/ПРИГ ЭМУЛЬС Д/ ЭНДОТРАХЕАЛЬНОГО ВВЕД																							
ЛИОФИЛИЗАТ ДЛЯ ПРИГОТОВЛЕНИЯ СУСПЕНЗИИ ДЛЯ ПОДКОЖНОГО ВВЕДЕНИЯ И НАКОЖНОГО СКАРИФИКАЦИОННОГО НАНЕСЕНИЯ	ЛИОФ-Т Д/ПРИГ-Я СУСП Д/НАКОЖСКАРИФИКАЦ НАНЕС И П/КН ВВЕД																							
ЛИОФИЛИЗАТ ДЛЯ ПРИГОТОВЛЕНИЯ СУСПЕНЗИИ ДЛЯ ПОДКОЖНОГО ВВЕДЕНИЯ И НАКОЖНОГО СКАРИФИКАЦИОННОГО НАНЕСЕНИЯ	ЛИОФ-Т Д/ПРИГ-Я СУСП Д/НАКОЖСКАРИФИКАЦ НАНЕС-Я И П/КН ВВЕД-Я																							
ЛИОФИЛИЗАТ ДЛЯ ПРИГОТОВЛЕНИЯ ЭМУЛЬСИИ ДЛЯ ЭНДОТРАХЕАЛЬНОГО ЭНДОБРОНХИАЛЬНОГО И ИНГАЛЯЦИОННОГО ВВЕДЕНИЯ	ЛИОФ-Т Д/ПРИГ-Я ЭМУЛЬС Д/ЭНДОТРАХЕАЛЬНОГО ВВЕД																							
ЛИОФИЛИЗАТ ДЛЯ ПРИГОТОВЛЕНИЯ СУСПЕНЗИИ ДЛЯ ПОДКОЖНОГО ВВЕДЕНИЯ И НАКОЖНОГО СКАРИФИКАЦИОННОГО НАНЕСЕНИЯ	ЛИОФИЛ Д/ ПРИГ СУСП Д/ НАКОЖ СКАРИФИКАЦ НАНЕС И П/К ВВЕД																							
ЛИОФИЛИЗАТ ДЛЯ ПРИГОТОВЛЕНИЯ ЭМУЛЬСИИ ДЛЯ ЭНДОТРАХЕАЛЬНОГО ЭНДОБРОНХИАЛЬНОГО И ИНГАЛЯЦИОННОГО ВВЕДЕНИЯ	ЛИОФИЛ Д/ ПРИГ ЭМУЛЬС Д/ ЭНДОТРАХЕАЛЬНОГО ВВЕД																							
ЛИОФИЛИЗАТ ДЛЯ ПРИГОТОВЛЕНИЯ СУСПЕНЗИИ ДЛЯ ВНУТРИМЫШЕЧНОГО И ПОДКОЖНОГО ВВЕДЕНИЯ ПРОЛОНГИРОВАННОГО ДЕЙСТВИЯ	ЛИОФИЛ Д/ПРИГ СУСПД/В/М И П/К ВВЕД ПРОЛОНГИРДЕЙСТВ																							
ЛИОФИЛИЗАТ ДЛЯ ПРИГОТОВЛЕНИЯ РАСТВОРА ДЛЯ ВНУТРИМЫШЕЧНОГО СУБКОНЪЮНКТИВАЛЬНОГО ВВЕДЕНИЯ И ЗАКАПЫВАНИЯ В ГЛАЗ	ЛИОФИЛ Д/ПРИГ Р-РА Д/В/М СУБКОНЪЮНКТИВ ВВЕД И Д/ЗАКАП В ГЛАЗА																							
ПОРОШОК ДЛЯ ПРИГОТОВЛЕНИЯ РАСТВОРА Д/ВНУТРИВЕННОГО И ВНУТРИМЫШЕЧНОГО ВВЕДЕНИЯ+РАСТВОРИТЕЛЬ ВОДА ДЛЯ ИНЪКЦИЙ АМП5МЛ N2	ПОР Д/ПРИГ Р-РА Д/В/В И В/М ВВЕД+Р-ЛЬ ВОДА Д/ИН АМП 5 МЛ N2																							
 ТАБЛЕТКИ 	 ТБЛ 																							
КАПЛИ УШНЫЕ	кап.ушн.																							
 ТАБЛЕТКИ 	 тбл 																							
СУППОЗИТОРИИ ВАГИНАЛЬНЫЕ	супп.вагин.																							
ТАБЛЕТКИ ШИПУЧИЕ	тбл шип.																							
 ШИПУЧИЕ 	 ШИП. 																							
КАПЛИ ГЛАЗНЫЕ	капли гл.																							
 ГЛАЗНЫЕ	 ГЛ.																							
ТРУБЧАТЫЙ ЭЛАСТИЧНЫЙ ДЛЯ ФИКСАЦИИ 	трубч. эласт.д/фикс.																							
ТРУБЧАТЫЙ	 ТРУБЧ.																							
 ЭЛАСТИЧНЫЙ	 ЭЛАСТ.																							
ФИКСАЦИИ	фикс.																							
 РАСТВОРА	 Р-РА																							
ДЛЯ ИНЪЕКЦИЙ	д/инъ																							
ТЫСЯЧ ЕДИНИЦ	ТЫС.ЕД																							
ТЫСЯЧ ЕДИНИЦ	ТЫС. ЕД																							
 	. 																							
	 НПО																							
	 ФГУП																							
 ТАБЛЕТКИ	, тбл																							
КАПЛИ НАЗАЛЬНЫЕ 	капли наз 																							
 ПОКРЫТЫЕ ОБОЛОЧКОЙ 	 п/о 																							
 БЕЗ ГАЗА	 б/газа																							
 БЕЗ 	 Б/																							
ТАБЛЕТКИ СУБЛИНГВАЛЬНЫЕ	тбл сублингв.																							
КОНЦЕНТРАТ ДЛЯ ИНФУЗИЙ	конц.д/инф 																							
 ДЛЯ РАССАСЫВАНИЯ	 д/расс																							
 РАЗМЕР 	 РАЗМЕР																							
 КИШЕЧНОРАСТВОРИМЫЕ 	 кишечнор 																							
 КИШЕЧНОРАСТВОРИМЫЕ 	 кишечнор.																							
 ЛИОФИЛИЗАТ 	 ЛИОФ. 																							
 ВАГИНАЛЬНЫЕ 	 ВАГИН.																							
 ГИДРОХЛОРИД 	 Г/ХЛ																							
ЛАК ДЛЯ НОГТЕЙ	лак д/ногтей																							
	 АГ/БЕРЛИН-ФАРМА																							
	 ФАРМАЦЕВТИЧЕСКИЙ ЗАВОД																							
	 ГМБХ																							
	 GMBH																							
BOEHRINGER	BOEHRINGER INGELHEIM PHARMA GMBH																							
	 ARZ.																							
JANSSEN	JANSSEN PHARMACEUTICA NV																							
CHINOIN	CHINOIN PHARMAC. AND CHEMICAL WORKS																							
	 S.R.O.																							
RANBAXY	RANBAXY LABORATORIES LIMITED																							
	 S.P.A.																							
CADILA	CADILA PHARMACEUTICALS																							
	ФАРМ.ФИРМА																							
KRKA	КРКА Д.Д. NOVO MESTO																							
 KRKA 	 КРКА 																							
ФФ	ФАРМФАБРИКА																							
	 ГУП																							
	Неизвестный производитель																							
	 ХЕЛСКЭАР																							
	 ЛИМИТЕД																							
ABBOTT	ABBOTT BIOLOGICALS																							
ABBOTT	ABBOTT FRANCE																							
ABBOTT	ABBOTT HEALTHCARE SAS																							
ABBOTT	ABBOTT JAPAN CO.																							
ABBOTT	ABBOTT LABORATORIES GMBH																							
ABBOTT	ABBOTT PRODUCTS GMBH																							
ACTAVIS	ACTAVIS HT.																							
ADAMED	ADAMED CONSUMER HEALTHCARE S.A.																							
AGIO	AGIO PHARMACEUTICALS																							
ALCON	ALCON COUVREUR S.A.																							
ALCON	ALCON-CUSI																							
ALCON	ALCON-LABORATORIES																							
ALVOGEN	ALVOGEN IPCO S.A.R.L																							
ASTELLAS	ASTELLAS PHARMA EUROPE .																							
ASTELLAS	ASTELLAS PHARMA EUROPE .-ОРТАТ																							
ASTELLAS	ASTELLAS PHARMA S.P.A																							
ASTELLAS	ASTELLAS PHARMA TECHNOLOGIES INC																							
ASTRA ZENECA	ASTRA ZENECA AB																							
ASTRA ZENECA	ASTRA ZENECA AB-ASTRAZENECA GMBH																							
ASTRA ZENECA	ASTRAZENECA																							
ASTRA ZENECA	ASTRAZENECA PHARM. LP-ASTRAZENECA UK																							
AVENTIS	AVENTIS INTERCONTINENTAL																							
AVENTIS	AVENTIS PHARMA																							
AVENTIS	AVENTIS PHARMA DEUTSCHLAND GMBH																							
AVENTIS	AVENTIS/ RHONE-POULENC RORER																							
AVENTIS	AVENTIS/ USIFAR																							
BALKANPHARMA	BALKANPHARMA																							
BALKANPHARMA	BALKANPHARMA - DUPNITZA AD																							
BAUSCH & LOMB	BAUSCH & LOMB																							
BAUSCH & LOMB	BAUSCH & LOMB INCORPORATED																							
BAYER	BAYER AG																							
BAYER	BAYER BITTERFALD GMBH																							
BAYER	BAYER CONSUMER CARE AG																							
BAYER	BAYER HEALTHCARE AG																							
BAYER	BAYER PHARMA AG																							
BAYER	BAYER SANTE FAMILIALE																							
BAYER	BAYER SCHERING PHARMA AG																							
BAYER	BAYER WEIMAR GMBH & CO.KG																							
BELUPO	BELUPO PHARMACEUTICALS AND COSMETICS D.D																							
BERLIN-CHEMIE	BERLIN-CHEMIE AG																							
BERLIN-CHEMIE	BERLIN-CHEMIE AG/ЗИО ЗДОРОВЬЕ																							
BERLIN-CHEMIE	BERLIN-CHEMIE/ MENARINI GROUP																							
BOEHRINGER INGEIHEIM	BOEHRINGER INGEIHEIM ITAIY S.P.A.																							
BOEHRINGER INGEIHEIM	BOEHRINGER INGELHEIM ELLAS A.E.																							
BOEHRINGER INGEIHEIM	BOEHRINGER INGELHEIM ESPANA S.A.																							
BOEHRINGER INGEIHEIM	BOEHRINGER INGELHEIM PHARMA GMBH																							
BRISTOL-MYERS	BRISTOL-MYERS /BRISTOL-MYERS SQUBB S.R.L																							
BRISTOL-MYERS	BRISTOL-MYERS SQUBB S.R.L																							
BRISTOL-MYERS	BRISTOL-MYERS SQUIBB																							
CATALENT	CATALENT FRANCE BEINHEIM S.A.																							
CATALENT	CATALENT FRANCE BEINHEIM SA-INNOTHERA																							
CATALENT	CATALENT GERMANY SCHORNDORF GMBH																							
CATALENT	CATALENT ITALI S.P.A																							
CATALENT	CATALENT PHARMA SOLUTIONS																							
CATALENT	CATALENT U.K.SWINDON ZYDIS LIMITED																							
CATALENT	CATALENT UK SWINDON ZYDIS																							
CATALENT	CATALENT UK SWINDON ZYDIS/LILLY S.A.																							
CATALENT	CATALENTU.K.SWINDON ZYDIS-JANSSEN-CILAG																							
CHINOIN	CHINOIN PHARMAC. AND CHEMICAL WORKS																							
DELFARM	DELFARM DIJON PVT																							
DELFARM	DELFARM YINING SAS																							
DELFARM	DELPHARM GAILLARD																							
DELFARM	DELPHARM LILLE S.A.S.																							
DELFARM	DELPHARM REIMS																							
GEDEON RICHTER	GEDEON RICHTER																							
GEDEON RICHTER	GEDEON RICHTER /GED. RICH. ROMANIASA																							
GEDEON RICHTER	GEDEON RICHTER POLAND CO																							
GEDEON RICHTER	GEDEON RICHTER/ ГЕДЕОН-РИХТЕР-РУС																							
GLAXO WEOME	GLAXO WEOME OPERATIONS																							
GLAXO WEOME	GLAXO WEOME POZNAN S.A.																							
GLAXO WEOME	GLAXO WEOME PRODUCTION																							
GLAXO WEOME	GLAXO WEOME SA																							
GLAXO WEOME	GLAXO WEOME/GLAXOSMITHKLINE PHARM SA																							
GLAXO WEOME	GLAXO WEOME/GLAXOSMITHKLINE PHARMAC.																							
GLAXOSMITHKLINE	GLAXOSMITHKLINE DUNGARVAN																							
GLAXOSMITHKLINE	GLAXOSMITHKLINE PHARMACEUTICALS S.A																							
GLENMARK	GLENMARK GENERICS LIMITED																							
GLENMARK	GLENMARK PHARMACEUTICALS																							
GLENMARK	GLENMERY BIOTECHNOLOGIES																							
GLENMARK	GLENMERY BIOTECHNOLOGIES-FEZ BISHKEK OCC																							
JANSSEN-CILAG	JANSSEN-CILAG																							
JANSSEN-CILAG	JANSSEN-CILAG S A																							
JANSSEN-CILAG	JANSSEN-CILAG S.P.A.																							
JANSSEN-CILAG	JANSSEN-CILAG S.P.A./ БИОТЕЭК МФПДК																							
JELFA	JELFA PHARMACEUTICAL COMPANY S.A.																							
JELFA	JELFA S.A.																							
JOHNSON & JOHNSON	JOHNSON & JOHNSON																							
JOHNSON & JOHNSON	JOHNSON & JOHNSON CONSUMER FRANCE S.A.S.																							
JOHNSON & JOHNSON	JOHNSON & JOHNSON GMBH																							
KRKA	KRKA D.D. NOVO MESTO/ ВЕКТОР-МЕДИКА																							
KRKA	KRKA D.D. NOVO MESTO/КРКА-РУС																							
KRKA	KRKA D.D./ ВЕКТОР-МЕДИКА																							
MERCK	MERCK KGAA & CO																							
MERCK	MERCK KGAA & CO.WERK SPIRITAL																							
MERCK	MERCK SANTE S.A.S.																							
MERCK	MERCK SHARP & DOHME -АКРИХИН ХФК																							
MERCK	MERCK SHARP & DOHME(ВЕЛИКОБРИТ)																							
MERCK	MERCK SHARP & DOHNE .																							
MERCK	MERCK SHARP&DOHNE .-MSD INTERNATIONAL																							
NOVARTIS	NOVARTIS CONSUMER HEALTH SA																							
NOVARTIS	NOVARTIS ENTERPRISES LIMITED																							
NOVARTIS	NOVARTIS PHARMA AG																							
NOVARTIS	NOVARTIS PHARMA PRODUCTIONS GMBH																							
NOVARTIS	NOVARTIS PHARMA S.A.																							
NOVARTIS	NOVARTIS PHARMA S.A.S.																							
NOVARTIS	NOVARTIS PHARMA S.P.A																							
NOVARTIS	NOVARTIS PHARMA STEIN AG																							
NOVARTIS	NOVARTIS SAGLIK GIDA VE TARIM URUNERY SA																							
NOVARTIS	NOVARTIS URUNLERI																							
NOVO NORDISK	NOVO NORDISK A/S																							
NYCOMED	NYCOMED AUSTRIA GMBH																							
NYCOMED	NYCOMED DANMARK A/S																							
NYCOMED	NYCOMED DANMARK APS																							
NYCOMED	NYCOMED PHARMA SP.Z O.O.																							
PFIZER	PFIZER																							
PFIZER	PFIZER HEALTH AB																							
PFIZER	PFIZER IRELAND PHARMACEUTICALS /GOEDECKE																							
PFIZER	PFIZER ITALIA S.R.L																							
PFIZER	PFIZER MANUFACTURING DEUTSCHLAND																							
PFIZER	PFIZER MFG BELGIUM N. V.																							
PFIZER	PFIZER S.A.																							
PLIVA	PLIVA																							
PLIVA	PLIVA D.D.																							
PLIVA	PLIVA/СОТЕКС (Г.МОСКВА)																							
POLFA	POLFA KRAKOWSKIE PHARMACEUTICAL WORKS																							
POLFA	POLFA PHARMACEUTICAL WORKS																							
POLFA	POLFA/ GRODZISKIE PW																							
POLPHARMA	POLPHARMA PHARMACEUTICAL WORKS S.A.																							
PROCTER & GAMBLE	PROCTER & GAMBLE																							
PROCTER & GAMBLE	PROCTER & GAMBLE HYGINETT																							
PROCTER & GAMBLE	PROCTER & GAMBLE MANUFACTURING																							
PROCTER & GAMBLE	PROCTER & GAMBLE TAMBRANDS UKRAINE																							
RECKITT BENCKISER	RECKITT BENCKISER																							
RECKITT BENCKISER	RECKITT BENCKISER HEALTHCARE INTERN																							
RECKITT BENCKISER	RECKITT BENCKISER HEALTHCARE LIMITED																							
ROCHE	ROCHE S.A																							
ROCHE	ROCHE S.P.A																							
ROCHE	ROCHE S.P.A.-F.HOFFMANN-LA ROCHE																							
SANOFI AVENTIS	SANOFI AVENTIS																							
SANOFI AVENTIS	SANOFI AVENTIS SA																							
SANOFI AVENTIS	SANOFI-AVENTIS S.P.A.																							
SANOFI AVENTIS	SANOFI-AVENTIS SAU																							
SANOFI AVENTIS	SANOFI-AVENTIS SP. Z O.O																							
SCHERING-PLOUGH	SCHERING-PLOUGH LABO N.V.																							
SCHERING-PLOUGH	SCHERING-PLOUGH PHARMA LDA																							
SCHERING-PLOUGH	SCHERING-PLOUGH PRODUCT																							
STADA	STADA ARZNEIMITTEL AG																							
TAKEDA	TAKEDA AC																							
TAKEDA	TAKEDA AUSTRIA GMBH																							
TAKEDA	TAKEDA GMBH																							
TAKEDA	TAKEDA IRELAND .																							
TAKEDA	TAKEDA PHARMA SP.Z.O.O																							
TAKEDA	TAKEDA PHARMACEUTICAL																							
TEVA	TEVA CZECH INDUSTRIES S.R.O.																							
TEVA	TEVA KUTNO																							
TEVA	TEVA OPERATIONS POLAND SP. Z O.O.																							
TEVA	TEVA PHARMA S.L.U.																							
TEVA	TEVA PHARMACEUTICAL INDUSTRIES																							
TEVA	TEVAPHARMACEUTICAL WORKS PRIVATE CO																							
URSAPHARM	URSAPHARM ARZNEIMITTEL GMBH																							
URSAPHARM	URSAPHARM ARZNEIMITTEL GMBH-MERCK																							
URSAPHARM	URSAPHARM ARZNEIMITTEL GMBH-MERZ PHARMA																							
АВВА РУС	АВВА РУС АО																							
ASTELLAS	АСТЕЛЛАС																							
ASTELLAS	АСТЕЛЛАС ФАРМА TEX КО /АСТЕЛЛАС ИРЛАН																							
ASTRA-ZENECA	АСТРАЗЕНЕКА АБ -ВЛ. АСПЕН ФАРМА																							
ASTRA ZENECA	АСТРАЗЕНЕКА АБ/АСТРАЗЕНЕКА ИНДАСТРИЗ																							
ASTRA ZENECA	АСТРАЗЕНЕКА АБ/ЗИО-ЗДОРОВЬЕ																							
ASTRA ZENECA	АСТРАЗЕНЕКА ФАРМ.ЛП/АСТРАЗЕНЕКА ИНДАСТРИ																							
ASTRA ZENECA	АСТРА ЗЕНЕКА																							
ASTRA ZENECA	АСТРАЗЕНЕКА																							
ASTRA ZENECA	АСТРАЗЕНЕКА ФАРМАСЬЮТИКАЛ/АСТРАЗЕНЕКА АБ																							
BAYER	БАЙЕР ОЙ																							
BAYER	БАЙЕР ФАРМА АГ/ЭЙСИКА ФАРМАСЬЮТИКАЛЗ																							
BAYER	БАЙЕР ХЕЛСКЭР АГ/ШВАРЦ ФАРМА ПРОДУКЦИОНС																							
BAYER	БАЙЕР ХЕЛСКЭР МАНУФЭКЧУРИНГ С.Р.Л.																							
BAXTER	БАКСТЕР ОНКОЛОГИЯ ГМБХ																							
BALCANPHARMA	БАЛКАНФАРМА-ТРОЯН АД																							
BOEHRINGER INGEIHEIM	БЕРИНГЕР ИНГЕЛЬХАЙМ ИНТЕРНЕШНЛ																							
BOEHRINGER INGEIHEIM	БЕРИНГЕР ИНГЕЛЬХАЙМ ЭЛЛАС-ВЛ. САНОФИ																							
BOEHRINGER INGEIHEIM	БЕРИНГЕР ИНГЕЛЬХАЙМ ЭСПАНА-ВЛ. САНОФИ																							
BOEHRINGER INGEIHEIM	БЕРИНГЕР ИНГЕЛЬХАЙМ/ДЕЛЬФАРМ																							
BOEHRINGER INGEIHEIM	БЕРИНГЕР ИНГЕЛЬХАЙМ/ДЕЛЬФАРМ-ВЛ. САНОФИ																							
BERLIN-CHEMIE	БЕРЛИН-ХЕМИ АГ																							
BERLIN-CHEMIE	БЕРЛИН-ХЕМИ АГ/БЕРЛИН-ФАРМА																							
BERLIN-CHEMIE	БЕРЛИН-ХЕМИ АГ/МЕНАРИНИ-ФОН ХЕЙДЕН ГМБХ																							
VISHI	ВИШИ ЛАБ																							
МХФП	МОСХИМФАРМПРЕПАРАТЫ ИМ.СЕМАШКО																							
NOVARTIS	НОВАРТИС																							
NOVARTIS	НОВАРТИС НЕВА																							
NOVARTIS	НОВАРТИС СИНГАПУР/НОВАРТИС НЕВА																							
NOVARTIS	НОВАРТИС ФАРМА С.П.А./НОВАРТИС НЕВА																							
NOVARTIS	НОВАРТИС ФАРМА ШТЕЙН АГ/НОВАРТИС НЕВА																							
PROCTER & GAMBLE	ПРОКТЕР ЭНД ГЭМБЛ																							
PFIZER	ПФАЙЗЕР КОНСЬЮМЕР МЭНЮФЭКЧ./ФЕРРОСАН СРЛ																							
PFIZER	ПФАЙЗЕР КОНСЬЮМЕР ХЕЛСКЭР																							
PFIZER	ПФАЙЗЕР МЭНЮФЭКЧУРИНГ ДОЙЧЛ./Р-ФАРМ ГМБХ																							
PFIZER	ПФАЙЗЕР ФАРМАСЬЮТ/ПФАЙЗЕР МЭНЮФ.ДОЙЧЛЕНД																							
Reckitt Benckiser	РЕКИТТ БЕНКИЗЕР ХЕЛСКЭАР																							
Reckitt Benckiser	РЕКИТТ БЕНКИЗЕР ХЕЛСКЭР ИНДИЯ ЛИМИТЕД																							
SANOFI	САНОФИ ВИНТРОП ИН ДЛЯ ФАРМСТАНДАРТ-УФАВИТА																							
SANOFI-AVENTIS	САНОФИ																							
SANOFI-AVENTIS	САНОФИ-АВЕНТИС ВОСТОК																							
SANOFI-AVENTIS	САНОФИ-АВЕНТИС ДЕ МЕКСИКО С.А. ДЕ С.В.																							
SANOFI-AVENTIS	САНОФИ-АВЕНТИС ДОЙЧЛАН ДЛЯ САНОФИ-АВ.ВОСТОК																							
СУППОЗИТОРИИ РЕКТАЛЬНЫЕ	СУПП РЕКТАЛ																							
КОНЦЕНТРАТ ДЛЯ ПРИГОТОВЛЕНИЯ РАСТВОРА ДЛЯ ИНФУЗИЙ	КОНЦ.Д/Р-РА Д/ИНФ.																							
КАПЛИ НАЗАЛЬНЫЕ	КАПЛИ НАЗ.																							
 КАПЛИ ГЛАЗНЫЕ 	 КАПЛИ ГЛ.																							
 ЗАВОД 	 З-Д 																							
	КОНСЬЮМЕР ХЕЛСКЭР																							
 ПОЛУАВТОМАТ	 П/АВТОМАТ																							
 ДЛЯ ПРИГОТОВЛЕНИЯ РАСТВОРА	 Д/Р-РА																							
 ТАБЛЕТКИ ПОКРЫТЫЕ ОБОЛОЧКОЙ	 ТАБ. П/О																							
 ТАБЛЕТКИ ПОКРЫТЫЕ ПЛЕНОЧНОЙ ОБОЛОЧКОЙ	 ТАБ. П/П/О																							
 ГРАНУЛЫ ДЛЯ ПРИГОТОВЛЕНИЯ СУСПЕНЗИИ	 ГРАН. Д/СУСП. 																							
 ДЛЯ ПРИГОТОВЛЕНИЯ СУСПЕНЗИИ	 Д/СУСП.																							
 КИШЕЧНОРАСТВОРИМЫЕ	  КШ/РАСТВ.																							
 ТАБЛЕТКИ КИШЕЧНОРАСТВОРИМЫЕ ПОКРЫТЫЕ ОБОЛОЧКОЙ 	 ТАБ.КШ/РАСТВ. П/О																							
 ТАБЛЕТКИ ПРОЛОНГИРОВАННОГО ДЕЙСТВИЯ ПОКРЫТЫЕ ПЛЕНОЧНОЙ ОБОЛОЧКОЙ	 ТАБ.ПРОЛОНГ. П/П/О																							
 ДЛЯ ПРИГОТОВЛЕНИЯ РАСТВОРА ДЛЯ ИНЪЕКЦИЙ	 Д/Р-РА Д/ИН.																							
 ДЛЯ ИЪЕКЦИЙ	 Д/ИН.																							
 ТАБЛЕТКИ	 ТАБ.																							
 ЗУБНАЯ ЩЕТКА	 ЗУБ.ЩЕТКА																							
 ПАКЕТЫ	 ПАК.																							
 ТАБЛЕТКИ ПРОЛОНГИРОВАННОГО ДЕЙСТВИЯ	ТАБ.ПРОЛОНГ.																							
 ДЛЯ РАССАСЫВАНИЯ	 Д/РАСС.																							
 ГЛАЗНЫЕ КАПЛИ	 ГЛ.КАПЛИ																							
ФЛАКОН-КАПЕЛЬНИЦА	ФЛ./КАП.																							
 АНТИБАКТЕРИАЛЬН	 А/БАКТЕР.																							
 ДЛЯ МЕСТНОГО ПРИМЕНЕНИЯ ДОЗИРОВАННЫЙ	  Д/МЕСТ.ПРИМ. ДОЗИР.																							
 ТАБЛЕТКИ ВАГИНАЛЬНЫЕ	 ТАБ.ВАГИН.																							
КАПСУЛЫ ЖЕВАТЕЛЬНЫЕ	 КАПС. ЖЕВ.																							
 ТАБЛЕТКИ С МОДИФИЦИРОВАННЫМ ВЫСВОБОЖДЕНИЕМ ПОКРЫТЫЕ ПЛЕНОЧНОЙ ОБОЛОЧКОЙ	 ТАБ. МОДИФ.ВЫСВ. П/П/О 																							
 ПОКРЫТЫЕ ПЛЕНОЧНОЙ ОБОЛОЧКОЙ	 П/П/О																							
 ПОРОШОК ДЛЯ ИНГАЛЯЦИЙ	 ПОР. Д/ИНГ.																							
 ДЛЯ ИНГАЛЯЦИЙ	 Д/ИНГ.																							
 ПОКРЫТЫЕ ОБОЛОЧКОЙ	 П/О																							
 МОДИФИЦИРОВАННОГО ВЫСВОБОЖДЕНИЯ ПОКРЫТЫЕ ОБОЛОЧКОЙ	 МОДИФ.ВЫСВ. П/О																							
 ТАБЛЕТКИ	  ТАБ.																							
 A&D	  [AND]																							
 ТАБЛЕТКИ ДИСПРЕРГИРУЕМЫЕ	 ТАБ. ДИСПЕРГ.																							
 ДИСПЕРГИРУЕМЫЕ	 ДИСПЕРГ.																							
 КИШЕЧНОРАСТВОРИМЫЕ	 КШ/РАСТВ.																							
ТАБЛЕТКИ ПРОЛОНГИРОВАННОГО ДЕЙСТВИЯ	 ТАБ.ПРОЛОНГ.																							
 МОДИФИЦИРОВАННОГО ВЫСВОБОЖДЕНИЯ	 МОДИФ.ВЫСВ.																							
РАСТВОР ВАГИНАЛЬНЫЙ ФЛАКОН-СПРИНЦОВКА	 Р-Р ВАГИН. ФЛ.-СПРИНЦОВКА																							
																								
																								
																								
																								
																								
																								
																								
																								
																								
																								
																								
																								
																								
																								
																								
																								
																								
																								
																								
																								
																								
																								
																								
																								
																								
																								
																								
																								
																								
																								
																								
																								
																								
																								
																								
																								
																								
																								
																								
																								
																								
																								
																								
																								
																								
																								
																								
																								
																								
																								
																								
																								
																								
																								
																								
																								
																								
																								
																								
																								
																								
																								
																								
																								
																								
																								
																								
																								
																								
																								
																								
																								
																								
																								
																								
																								
																								
																								
																								
																								
																								
																								
																								
																								
																								
																								
																								
																								
																								
																								
																								
																								
																								
																								
																								
																								
																								
																								
																								
																								
																								
																								
																								
																								
																								
																								
																								
																								
																								
																								
																								
																								
																								
																								
																								
																								
																								
																								
																								
																								
																								
																								
																								
																								
																								
																								
																								
																								
																								
																								
																								
																								
																								
																								
																								
																								
																								
																								
																								
																								
																								
																								
																								
																								
																								
																								
																								
																								
																								
																								
																								
																								
																								
																								
																								
																								
																								
																								
																								
																								
																								
																								
																								
																								
																								
																								
																								
																								
																								
																								
																								
																								
																								
																								
																								
																								
																								
																								
																								
																								
																								
																								
																								
																								
																								
																								
																								
																								
																								
																								
																								
																								
																								
																								
																								
																								
																								
																								
																								
																								
																								
																								
																								
																								
																								
																								
																								
																								
																								
																								
																								
																								
																								
																								
																								
																								
																								
																								
																								
																								
																								
																								
																								
																								
																								
																								
																								
																								
																								
																								
																								
																								
																								
																								
																								
																								
																								
																								
																								
																								
																								
																								
																								
																								
																								
																								
																								
																								
																								
																								
																								
																								
																								
																								
																								
																								
																								
																								
																								
																								
																								
																								
																								
																								
																								
																								
																								
																								
																								
																								
																								
																								
																								
																								
																								
																								
																								
																								
																								
																								
																								
																								
																								
																								
																								
																								
																								
																								
																								
																								
																								
																								
																								
																								
																								
																								
																								
																								
																								
																								
																								
																								
																								
																								
																								
																								
																								
																								
																								
																								
																								
																								
																								
																								
																								
																								
																								
																								
																								
																								
																								
																								
																								
																								
																								
																								
																								
																								
																								
																								
																								
																								
																								
																								
																								
																								
																								
																								
																								
																								
																								
																								
																								
																								
																								
																								
																								
																								
																								
																								
																								
																								
																								
																								
																								
																								
																								
																								
																								
																								
																								
																								
																								
																								
																								
																								
																								
																								
																								
																								
																								
																								
																								
																								
																								
																								
																								
																								
																								
																								
																								
																								
																								
																								
																								
																								
																								
																								
																								
																								
																								
																								
																								
																								
																								
																								
																								
																								
																								
																								
																								
																								
																								
																								
																								
																								
																								
																								
																								
																								
																								
																								
																								
																								
																								
																								
																								
																								
																								
																								
																								
																								
																								
																								
																								
																								
																								
																								
																								
																								
																								
																								
																								
																								
																								
																								
																								
																								
																								
																								
																								
																								
																								
																								
																								
																								
																								
																								
																								
																								
																								
																								
																								
																								
																								
																								
																								
																								
																								
																								
																								
																								
																								
																								
																								
																								
																								
																								
																								
																								
																								
																								
																								
																								
																								
																								
																								
																								
																								
																								
																								
																								
																								
																								
																								
																								
																								
																								
																								
																								
																								
																								
																								
																								
																								
																								
																								
																								
																								
																								
																								
																								
																								
																								
																								
																								
																								
																								
																								
																								
																								
																								
																								
																								
																								
																								
																								
																								
																								
																								
																								
																								
																								
																								
																								
																								
																								
																								
																								
																								
																								
																								
																								
																								
																								
																								
																								
																								
																								
																								
																								
																								
																								
																								
																								
																								
																								
																								
																								
																								
																								
																								
																								
																								
																								
																								
																								
																								
																								
																								
																								
																								
																								
																								
																								
																								
																								
																								
																								
																								
																								
																								
																								
																								
																								
																								
																								
																								
																								
																								
																								
																								
																								
																								
																								
																								
																								
																								
																								
																								
																								
																								
																								
																								
																								
																								
																								
																								
																								
																								
																								
																								
																								
																								
																								
																								
																								
																								
																								
																								
																								
																								
																								
																								
																								
																								
																								
																								
																								
																								
																								
																								
																								
																								
																								
																								
																								
																								
																								
																								
																								
																								
																								
																								
																								
																								
																								
																								
																								
																								
																								
																								
																								
																								
																								
																								
																								
																								
																								
																								
																								
																								
																								
																								
																								
																								
																								
																								
																								
																								
																								
																								
																								
																								
																								
																								
																								
																								
																								
																								
																								
																								
																								
																								
																								
																								
																								
																								
																								
																								
																								
																								
																								
																								
																								
																								
																								
																								
																								
																								
																								
																								
																								
																								
																								
																								
																								
																								
																								
																								
																								
																								
																								
																								
																								
																								
																								
																								
																								
																								
																								
																								
																								
																								
																								
																								
																								
																								
																								
																								
																								
																								
																								
																								
																								
																								
																								
																								
																								
																								
																								
